Codice Conto,Descrizione conto,Data operazione,COD,Descrizione operazione,Numero documento,Data documento,Numero Fattura,Importo,Saldo,Contropartita,Costi Diretti,Costi Indiretti,Attività economiche,Attività non economiche,Codice progetto
8.01.009,TRASPORTI PER ACQUISTI ,31/03/2021,199,ACQUISTI REVERSE CH,4655/21,15/03/2021,84,44.0,44.0,PACKSE PACK SERVICES S.R.,,,,,
8.01.009,TRASPORTI PER ACQUISTI ,30/04/2021,199,ACQUISTI REVERSE CH,036-21 ,30/03/2021,105,15.0,59.0,DORATE DORA TECNOLOGIE DI,,,,,
8.01.009,TRASPORTI PER ACQUISTI ,30/04/2021,1110,ACQUISTO IVA N/DETR,39,23/04/2021,127,-146.4,-87.4,DAMBGI DITTA D'AMBRA GIUS,,,,,
8.01.009,TRASPORTI PER ACQUISTI ,30/04/2021,199,ACQUISTI REVERSE CH,258/E ,29/04/2021,131,45.0,-42.40000000000001,NANOVI NANOVISION S.R.L.,,,,,
8.01.009,TRASPORTI PER ACQUISTI ,31/05/2021,199,ACQUISTI REVERSE CH,36007,30/04/2021,143,15.0,-27.40000000000001,VWR VWR INTERNATIONAL,,,,,
8.01.009,TRASPORTI PER ACQUISTI ,31/05/2021,199,ACQUISTI REVERSE CH,13 / PA,17/05/2021,157,15.0,-12.40000000000001,TRTURO T.R. TURONI S.R.L.,,,,,
8.01.009,TRASPORTI PER ACQUISTI ,31/05/2021,199,ACQUISTI REVERSE CH,214,24/05/2021,164,40.0,27.59999999999999,ECOSEA ECOSEARCH S.R.L.,,,,,
8.01.009,TRASPORTI PER ACQUISTI ,31/05/2021,199,ACQUISTI REVERSE CH,1286,26/05/2021,167,160.0,187.6,OPTOTR OPTOTRIM S.R.L.,,,,,
8.01.009,TRASPORTI PER ACQUISTI ,31/07/2021,199,ACQUISTI REVERSE CH,99238,30/06/2021,216,25.0,212.6,SIAD S.I.A.D. S.P.A.,,,,,
8.01.009,TRASPORTI PER ACQUISTI ,31/07/2021,199,ACQUISTI REVERSE CH,78,30/06/2021,224,40.0,252.6,GENTAU GENTAUR S.R.L. UNI,,,,,
8.01.009,TRASPORTI PER ACQUISTI ,31/07/2021,104,ACQUISTO MERCI NO R,3666,27/07/2021,249,10.0,262.6,SILCAM Silcam Italia S.r.,,,,,
8.01.009,TRASPORTI PER ACQUISTI ,31/07/2021,1100,FATTURA DI ACQUISTO,48,27/07/2021,250,-10.0,252.6,SILCAM Silcam Italia S.r.,,,,,
8.01.009,TRASPORTI PER ACQUISTI ,31/07/2021,199,ACQUISTI REVERSE CH,3668,27/07/2021,251,10.0,262.6,SILCAM Silcam Italia S.r.,,,,,
8.01.009,TRASPORTI PER ACQUISTI ,31/10/2021,199,ACQUISTI REVERSE CH,1149654,30/09/2021,324,25.0,287.6,SIAD S.I.A.D. S.P.A.,,,,,
8.01.009,TRASPORTI PER ACQUISTI ,31/10/2021,199,ACQUISTI REVERSE CH,5202740,05/10/2021,328,11.0,298.6,FARNEL FARNEL ITALIA S.R.,,,,,
8.01.009,TRASPORTI PER ACQUISTI ,31/10/2021,199,ACQUISTI REVERSE CH,453,01/10/2021,334,20.0,318.6,TECECO TECNO-ECO S.R.L.,,,,,
8.01.009,TRASPORTI PER ACQUISTI ,30/11/2021,199,ACQUISTI REVERSE CH,66737,31/10/2021,385,24.15,342.75,SIAD S.I.A.D. S.P.A.,,,,,
8.01.009,TRASPORTI PER ACQUISTI ,20/12/2021,199,ACQUISTI REVERSE CH,84994,30/11/2021,445,25.0,367.75,SIAD S.I.A.D. S.P.A.,,,,,
8.01.009,TRASPORTI PER ACQUISTI ,31/12/2021,199,ACQUISTI REVERSE CH,650,15/12/2021,460,20.0,387.75,TECECO TECNO-ECO S.R.L.,,,,,
8.01.010,SPESE SU ACQUISTI ,31/03/2021,199,ACQUISTI REVERSE CH,4655/21,15/03/2021,84,9.0,9.0,PACKSE PACK SERVICES S.R.,,,,,
8.01.010,SPESE SU ACQUISTI ,30/06/2021,199,ACQUISTI REVERSE CH,A5882 ,25/06/2021,199,29.0,38.0,PRODO1 PRODOTTI GIANNI SR,,,,,
8.01.010,SPESE SU ACQUISTI ,31/10/2021,199,ACQUISTI REVERSE CH,453,01/10/2021,334,5.0,43.0,TECECO TECNO-ECO S.R.L.,,,,,
8.01.031,SPESE DI SPEDIZIONE ,31/03/2021,199,ACQUISTI REVERSE CH,26290,28/02/2021,73,31.5,31.5,SIAD S.I.A.D. S.P.A.,,,,,
8.01.031,SPESE DI SPEDIZIONE ,30/04/2021,199,ACQUISTI REVERSE CH,40,23/04/2021,128,120.0,151.5,DAMBGI DITTA D'AMBRA GIUS,,,,,
8.01.031,SPESE DI SPEDIZIONE ,30/04/2021,199,ACQUISTI REVERSE CH,48792,31/03/2021,107,199.4,350.9,SIAD S.I.A.D. S.P.A.,,,,,
8.04.000,COSTO DEL PERSONALE ,20/12/2021,100,FATTURA DI ACQUISTO,64813,11/12/2021,451,840.0,840.0,AMAEU Amazon EU S.a r.l.,,,,,
8.04.002,STIPENDI IMPIEGATI ,31/01/2021,150,"RETRIBUZ,THETA GENN", ,31/01/2021, ,5707.0,5707.0, diversi a diversi,,,,,
8.04.002,STIPENDI IMPIEGATI ,31/01/2021,150,RETRIBUZ.BETA GENNA, ,31/01/2021, ,5981.0,11688.0, diversi a diversi,,,,,
8.04.002,STIPENDI IMPIEGATI ,31/01/2021,150,RETRIBUZ.LAMBDA GEN, ,31/01/2021, ,19782.0,31470.0, diversi a diversi,,,,,
8.04.002,STIPENDI IMPIEGATI ,28/02/2021,150,"RETRIBUZ,THETA FEBB", ,28/02/2021, ,5707.0,37177.0, diversi a diversi,,,,,
8.04.002,STIPENDI IMPIEGATI ,28/02/2021,150,RERIBUZ.LAMBDA FEBB, ,28/02/2021, ,19782.0,56959.0, diversi a diversi,,,,,
8.04.002,STIPENDI IMPIEGATI ,28/02/2021,150,"RETRIBUZ,BETA FEBBR", ,28/02/2021, ,5981.0,62940.0, diversi a diversi,,,,,
8.04.002,STIPENDI IMPIEGATI ,31/03/2021,150,RETRIBUZ.THETA MARZ, ,31/03/2021, ,5707.0,68647.0, diversi a diversi,,,,,
8.04.002,STIPENDI IMPIEGATI ,31/03/2021,150,RETRIBUZ.LAMBDA MAR, ,31/03/2021, ,19782.0,88429.0, diversi a diversi,,,,,
8.04.002,STIPENDI IMPIEGATI ,31/03/2021,150,RETRIBUZ.BETA MARZO, ,31/03/2021, ,5981.0,94410.0, diversi a diversi,,,,,
8.04.002,STIPENDI IMPIEGATI ,30/04/2021,150,RETRIBUZ.BETA APRIL, ,30/04/2021, ,6211.0,100621.0, diversi a diversi,,,,,
8.04.002,STIPENDI IMPIEGATI ,30/04/2021,150,RETRIBUZ.THETA APRI, ,30/04/2021, ,5926.0,106547.0, diversi a diversi,,,,,
8.04.002,STIPENDI IMPIEGATI ,30/04/2021,150,RETRIBUZ.LAMBDA APR, ,30/04/2021, ,20316.0,126863.0, diversi a diversi,,,,,
8.04.002,STIPENDI IMPIEGATI ,31/05/2021,150,"RETRIBUZ,LAMBDA MAG", ,31/05/2021, ,19782.0,146645.0, diversi a diversi,,,,,
8.04.002,STIPENDI IMPIEGATI ,31/05/2021,150,RETRIBUZ.ETA MAGGIO, ,31/05/2021, ,2395.0,149040.0, diversi a diversi,,,,,
8.04.002,STIPENDI IMPIEGATI ,31/05/2021,150,RETRIBUZ.THETA MAGG, ,31/05/2021, ,5865.0,154905.0, diversi a diversi,,,,,
8.04.002,STIPENDI IMPIEGATI ,31/05/2021,150,RETRIBUZ.BETA MAGGI, ,31/05/2021, ,7029.0,161934.0, diversi a diversi,,,,,
8.04.002,STIPENDI IMPIEGATI ,30/06/2021,150,RETRIBU.BETA GIUGNO, ,30/06/2021, ,3466.0,165400.0, diversi a diversi,,,,,
8.04.002,STIPENDI IMPIEGATI ,30/06/2021,150,"RETRIBUZ,LAMBDA GIU", ,30/06/2021, ,19782.0,185182.0, diversi a diversi,,,,,
8.04.002,STIPENDI IMPIEGATI ,30/06/2021,150,RETRIBUZ.ETA GIUGNO, ,30/06/2021, ,2395.0,187577.0, diversi a diversi,,,,,
8.04.002,STIPENDI IMPIEGATI ,30/06/2021,150,RETRIBUZIONI THETA , ,30/06/2021, ,6186.0,193763.0, diversi a diversi,,,,,
8.04.002,STIPENDI IMPIEGATI ,31/07/2021,150,"RETRIBUZ,LAMBDA LUG", ,31/07/2021, ,19350.0,213113.0, diversi a diversi,,,,,
8.04.002,STIPENDI IMPIEGATI ,31/07/2021,150,RETRIB.ETA LUGLIO , ,31/07/2021, ,2421.0,215534.0, diversi a diversi,,,,,
8.04.002,STIPENDI IMPIEGATI ,31/07/2021,150,RETRIBUZ.BETA LUGLI, ,31/07/2021, ,3495.0,219029.0, diversi a diversi,,,,,
8.04.002,STIPENDI IMPIEGATI ,31/07/2021,150,RETRIBUZ.THETA LUGL, ,31/07/2021, ,4629.0,223658.0, diversi a diversi,,,,,
8.04.002,STIPENDI IMPIEGATI ,31/08/2021,150,RETRIBUZ.BETA AGOST, ,31/08/2021, ,3763.0,227421.0, diversi a diversi,,,,,
8.04.002,STIPENDI IMPIEGATI ,31/08/2021,150,RETRIBUZ.THETA AGOS, ,31/08/2021, ,2148.0,229569.0, diversi a diversi,,,,,
8.04.002,STIPENDI IMPIEGATI ,31/08/2021,150,RETRIBUZ.LAMBDA AGO, ,31/08/2021, ,20846.0,250415.0, diversi a diversi,,,,,
8.04.002,STIPENDI IMPIEGATI ,31/08/2021,150,RETRIBUZ.ETA AGOSTO, ,31/08/2021, ,2608.0,253023.0, diversi a diversi,,,,,
8.04.002,STIPENDI IMPIEGATI ,30/09/2021,150,RETRIBUZ.THETA SETT, ,30/09/2021, ,1994.0,255017.0, diversi a diversi,,,,,
8.04.002,STIPENDI IMPIEGATI ,30/09/2021,150,RETRIBUZ.LAMBDA SET, ,30/09/2021, ,20451.0,275468.0, diversi a diversi,,,,,
8.04.002,STIPENDI IMPIEGATI ,30/09/2021,150,RETRIB.ETA SETTEMBR, ,30/09/2021, ,2421.0,277889.0, diversi a diversi,,,,,
8.04.002,STIPENDI IMPIEGATI ,30/09/2021,150,"RETRIBUZ,BETA SETTE", ,30/09/2021, ,6116.0,284005.0, diversi a diversi,,,,,
8.04.002,STIPENDI IMPIEGATI ,31/10/2021,150,RETRIBUZ.BETA OTTOB, ,31/10/2021, ,3650.0,287655.0, diversi a diversi,,,,,
8.04.002,STIPENDI IMPIEGATI ,31/10/2021,150,RETRIBUZ.LAMBDA OTT, ,31/10/2021, ,19902.0,307557.0, diversi a diversi,,,,,
8.04.002,STIPENDI IMPIEGATI ,31/10/2021,150,RETRIB.ETA OTTOBRE , ,31/10/2021, ,2421.0,309978.0, diversi a diversi,,,,,
8.04.002,STIPENDI IMPIEGATI ,31/10/2021,150,RETRIBUZ.THETA OTTO, ,31/10/2021, ,3656.0,313634.0, diversi a diversi,,,,,
8.04.002,STIPENDI IMPIEGATI ,30/11/2021,150,RETRIB.BETA NOVEMBR, ,30/11/2021, ,3790.0,317424.0, diversi a diversi,,,,,
8.04.002,STIPENDI IMPIEGATI ,30/11/2021,150,RETRIB.LAMBDA NOVEM, ,30/11/2021, ,20437.0,337861.0, diversi a diversi,,,,,
8.04.002,STIPENDI IMPIEGATI ,30/11/2021,150,RETRIB.ETA NOVEMBRE, ,30/11/2021, ,2515.0,340376.0, diversi a diversi,,,,,
8.04.002,STIPENDI IMPIEGATI ,31/12/2021,150,RETRIBUZ.BETA , ,31/12/2021, ,4703.0,345079.0, diversi a diversi,,,,,
8.04.002,STIPENDI IMPIEGATI ,31/12/2021,150,RETRIB.LAMBDA DICEM, ,31/12/2021, ,40341.0,385420.0, diversi a diversi,,,,,
8.04.002,STIPENDI IMPIEGATI ,31/12/2021,150,RETRIB.LAMBDA DICEM, ,31/12/2021, ,1120.0,386540.0, diversi a diversi,,,,,
8.04.002,STIPENDI IMPIEGATI ,31/12/2021,150,RETRIBUZ.ETA DICEMB, ,31/12/2021, ,4129.0,390669.0, diversi a diversi,,,,,
8.04.004,COMPENSI PER CONTRATTI A PROGETTO ,31/01/2021,150,COMPENSI ALFA GENNA, ,31/01/2021, ,3078.0,3078.0, diversi a diversi,,,,,
8.04.004,COMPENSI PER CONTRATTI A PROGETTO ,31/01/2021,150,RETRIBUZ.OMEGA GENN, ,31/01/2021, ,9488.0,12566.0, diversi a diversi,,,,,
8.04.004,COMPENSI PER CONTRATTI A PROGETTO ,31/01/2021,150,RETRIBUZ.KAPPA GENN, ,31/01/2021, ,1294.0,13860.0, diversi a diversi,,,,,
8.04.004,COMPENSI PER CONTRATTI A PROGETTO ,31/01/2021,150,RETRIBUZ.IOTA GENNA, ,31/01/2021, ,1557.0,15417.0, diversi a diversi,,,,,
8.04.004,COMPENSI PER CONTRATTI A PROGETTO ,31/01/2021,150,"RETRIBUZ,THETA GENN", ,31/01/2021, ,10870.0,26287.0, diversi a diversi,,,,,
8.04.004,COMPENSI PER CONTRATTI A PROGETTO ,31/01/2021,150,RETRIBUZ.BETA GENNA, ,31/01/2021, ,25589.0,51876.0, diversi a diversi,,,,,
8.04.004,COMPENSI PER CONTRATTI A PROGETTO ,28/02/2021,150,RETRIBUZ.ALFA FEBBR, ,28/02/2021, ,3078.0,54954.0, diversi a diversi,,,,,
8.04.004,COMPENSI PER CONTRATTI A PROGETTO ,28/02/2021,150,"RETRIBUZ,OMEGA FEBB", ,28/02/2021, ,6588.0,61542.0, diversi a diversi,,,,,
8.04.004,COMPENSI PER CONTRATTI A PROGETTO ,28/02/2021,150,RETRIBUZ.ZETA FEBBR, ,28/02/2021, ,734.0,62276.0, diversi a diversi,,,,,
8.04.004,COMPENSI PER CONTRATTI A PROGETTO ,28/02/2021,150,"RETRIBUZ,THETA FEBB", ,28/02/2021, ,10870.0,73146.0, diversi a diversi,,,,,
8.04.004,COMPENSI PER CONTRATTI A PROGETTO ,28/02/2021,150,RETRIBUZ.KAPPA FEBB, ,28/02/2021, ,2584.0,75730.0, diversi a diversi,,,,,
8.04.004,COMPENSI PER CONTRATTI A PROGETTO ,28/02/2021,150,RETRIBUZIONI TAU FE, ,28/02/2021, ,3188.0,78918.0, diversi a diversi,,,,,
8.04.004,COMPENSI PER CONTRATTI A PROGETTO ,28/02/2021,150,RETRIBUZ.IOTA FEBBR, ,28/02/2021, ,1557.0,80475.0, diversi a diversi,,,,,
8.04.004,COMPENSI PER CONTRATTI A PROGETTO ,28/02/2021,150,"RETRIBUZ,BETA FEBBR", ,28/02/2021, ,17451.0,97926.0, diversi a diversi,,,,,
8.04.004,COMPENSI PER CONTRATTI A PROGETTO ,31/03/2021,150,RETRIBUZ.ALFA MARZO, ,31/03/2021, ,1294.0,99220.0, diversi a diversi,,,,,
8.04.004,COMPENSI PER CONTRATTI A PROGETTO ,31/03/2021,150,RETRIBUZ.OMEGA MARZ, ,31/03/2021, ,6588.0,105808.0, diversi a diversi,,,,,
8.04.004,COMPENSI PER CONTRATTI A PROGETTO ,31/03/2021,150,RETRIBUZ.ZETA MARZO, ,31/03/2021, ,4104.0,109912.0, diversi a diversi,,,,,
8.04.004,COMPENSI PER CONTRATTI A PROGETTO ,31/03/2021,150,RETRIBUZ.THETA MARZ, ,31/03/2021, ,5069.0,114981.0, diversi a diversi,,,,,
8.04.004,COMPENSI PER CONTRATTI A PROGETTO ,31/03/2021,150,"RETRIBUZ,KAPPA MARZ", ,31/03/2021, ,2588.0,117569.0, diversi a diversi,,,,,
8.04.004,COMPENSI PER CONTRATTI A PROGETTO ,31/03/2021,150,RETRIBUZ.TAU MARZO , ,31/03/2021, ,3188.0,120757.0, diversi a diversi,,,,,
8.04.004,COMPENSI PER CONTRATTI A PROGETTO ,31/03/2021,150,RETRIBUZ.IOTA MARZO, ,31/03/2021, ,1557.0,122314.0, diversi a diversi,,,,,
8.04.004,COMPENSI PER CONTRATTI A PROGETTO ,31/03/2021,150,RETRIBUZ.BETA MARZO, ,31/03/2021, ,17181.0,139495.0, diversi a diversi,,,,,
8.04.004,COMPENSI PER CONTRATTI A PROGETTO ,30/04/2021,150,RETRIBUZ.ALFA APRIL, ,30/04/2021, ,1294.0,140789.0, diversi a diversi,,,,,
8.04.004,COMPENSI PER CONTRATTI A PROGETTO ,30/04/2021,150,RETRIBUZ.BETA APRIL, ,30/04/2021, ,15094.0,155883.0, diversi a diversi,,,,,
8.04.004,COMPENSI PER CONTRATTI A PROGETTO ,30/04/2021,150,"RETRIBUZ,OMEGA APRI", ,30/04/2021, ,6588.0,162471.0, diversi a diversi,,,,,
8.04.004,COMPENSI PER CONTRATTI A PROGETTO ,30/04/2021,150,RETRIBUZIONI ZETA A, ,30/04/2021, ,7232.0,169703.0, diversi a diversi,,,,,
8.04.004,COMPENSI PER CONTRATTI A PROGETTO ,30/04/2021,150,RETRIBUZ.THETA APRI, ,30/04/2021, ,5069.0,174772.0, diversi a diversi,,,,,
8.04.004,COMPENSI PER CONTRATTI A PROGETTO ,30/04/2021,150,RETRIBUZ.KAPPA AGOS, ,30/04/2021, ,2588.0,177360.0, diversi a diversi,,,,,
8.04.004,COMPENSI PER CONTRATTI A PROGETTO ,30/04/2021,150,RETRIBUZ.TAU APRILE, ,30/04/2021, ,4810.0,182170.0, diversi a diversi,,,,,
8.04.004,COMPENSI PER CONTRATTI A PROGETTO ,30/04/2021,150,RETRIBUZ.IOTA APRIL, ,30/04/2021, ,3431.0,185601.0, diversi a diversi,,,,,
8.04.004,COMPENSI PER CONTRATTI A PROGETTO ,31/05/2021,150,RETRIBUZ.ALFA MAGGI, ,31/05/2021, ,712.0,186313.0, diversi a diversi,,,,,
8.04.004,COMPENSI PER CONTRATTI A PROGETTO ,31/05/2021,150,RETRIBUZ.OMEGA MAGG, ,31/05/2021, ,3582.0,189895.0, diversi a diversi,,,,,
8.04.004,COMPENSI PER CONTRATTI A PROGETTO ,31/05/2021,150,RETRIBUZ.ZETA MAGGI, ,31/05/2021, ,7800.0,197695.0, diversi a diversi,,,,,
8.04.004,COMPENSI PER CONTRATTI A PROGETTO ,31/05/2021,150,RETRIBUZ.KAPPA MAGG, ,31/05/2021, ,2002.0,199697.0, diversi a diversi,,,,,
8.04.004,COMPENSI PER CONTRATTI A PROGETTO ,31/05/2021,150,RETRIBUZ.TAU MAGGIO, ,31/05/2021, ,4810.0,204507.0, diversi a diversi,,,,,
8.04.004,COMPENSI PER CONTRATTI A PROGETTO ,31/05/2021,150,RETRIBUZ.IOTA MAGGI, ,31/05/2021, ,3431.0,207938.0, diversi a diversi,,,,,
8.04.004,COMPENSI PER CONTRATTI A PROGETTO ,31/05/2021,150,RETRIBUZ.THETA MAGG, ,31/05/2021, ,2920.0,210858.0, diversi a diversi,,,,,
8.04.004,COMPENSI PER CONTRATTI A PROGETTO ,31/05/2021,150,RETRIBUZ.BETA MAGGI, ,31/05/2021, ,15094.0,225952.0, diversi a diversi,,,,,
8.04.004,COMPENSI PER CONTRATTI A PROGETTO ,30/06/2021,150,RETRIBUZ.ALFA GIUGN, ,30/06/2021, ,3582.0,229534.0, diversi a diversi,,,,,
8.04.004,COMPENSI PER CONTRATTI A PROGETTO ,30/06/2021,150,RETRIBU.BETA GIUGNO, ,30/06/2021, ,15240.0,244774.0, diversi a diversi,,,,,
8.04.004,COMPENSI PER CONTRATTI A PROGETTO ,30/06/2021,150,RETRIBUZ.OMEGA GIUG, ,30/06/2021, ,5725.0,250499.0, diversi a diversi,,,,,
8.04.004,COMPENSI PER CONTRATTI A PROGETTO ,30/06/2021,150,RETRIBUZ.ZETA GIUGN, ,30/06/2021, ,7800.0,258299.0, diversi a diversi,,,,,
8.04.004,COMPENSI PER CONTRATTI A PROGETTO ,30/06/2021,150,RETRIBUZ.KAPPA GIUG, ,30/06/2021, ,1290.0,259589.0, diversi a diversi,,,,,
8.04.004,COMPENSI PER CONTRATTI A PROGETTO ,30/06/2021,150,RETRIBUZ.TAU GIUGNO, ,30/06/2021, ,4810.0,264399.0, diversi a diversi,,,,,
8.04.004,COMPENSI PER CONTRATTI A PROGETTO ,30/06/2021,150,"RETRIBUZ,IOTA GIUGN", ,30/06/2021, ,3431.0,267830.0, diversi a diversi,,,,,
8.04.004,COMPENSI PER CONTRATTI A PROGETTO ,30/06/2021,150,RETRIBUZIONI THETA , ,30/06/2021, ,5069.0,272899.0, diversi a diversi,,,,,
8.04.004,COMPENSI PER CONTRATTI A PROGETTO ,31/07/2021,150,RETRIBUZ.ALFA LUGLI, ,31/07/2021, ,5745.0,278644.0, diversi a diversi,,,,,
8.04.004,COMPENSI PER CONTRATTI A PROGETTO ,31/07/2021,150,RETRIBUZ.OMEGA LUGL, ,31/07/2021, ,5725.0,284369.0, diversi a diversi,,,,,
8.04.004,COMPENSI PER CONTRATTI A PROGETTO ,31/07/2021,150,RETRIBUZ.KAPPA LUGL, ,31/07/2021, ,1290.0,285659.0, diversi a diversi,,,,,
8.04.004,COMPENSI PER CONTRATTI A PROGETTO ,31/07/2021,150,RETRIBUZ.TAU LUGLIO, ,31/07/2021, ,1440.0,287099.0, diversi a diversi,,,,,
8.04.004,COMPENSI PER CONTRATTI A PROGETTO ,31/07/2021,150,RETRIBUZ.IOTA LUGLI, ,31/07/2021, ,1557.0,288656.0, diversi a diversi,,,,,
8.04.004,COMPENSI PER CONTRATTI A PROGETTO ,31/07/2021,150,RETRIBUZ.RHO LUGLIO, ,31/07/2021, ,2122.0,290778.0, diversi a diversi,,,,,
8.04.004,COMPENSI PER CONTRATTI A PROGETTO ,31/07/2021,150,RETRIBUZ.BETA LUGLI, ,31/07/2021, ,18755.0,309533.0, diversi a diversi,,,,,
8.04.004,COMPENSI PER CONTRATTI A PROGETTO ,31/07/2021,150,"RETRIBUZ,ZETA LUGLI", ,31/07/2021, ,7800.0,317333.0, diversi a diversi,,,,,
8.04.004,COMPENSI PER CONTRATTI A PROGETTO ,31/07/2021,150,RETRIBUZ.THETA LUGL, ,31/07/2021, ,7991.0,325324.0, diversi a diversi,,,,,
8.04.004,COMPENSI PER CONTRATTI A PROGETTO ,31/07/2021,160,COMPENSO MARRONE CO, ,31/07/2021, ,-5070.91,320253.09,505004 DEBITI V/COLLABORA,,,,,
8.04.004,COMPENSI PER CONTRATTI A PROGETTO ,31/08/2021,150,RETRIBUZIONI ALFA A, ,31/08/2021, ,5745.0,325998.09, diversi a diversi,,,,,
8.04.004,COMPENSI PER CONTRATTI A PROGETTO ,31/08/2021,150,RETRIBUZ.BETA AGOST, ,31/08/2021, ,21608.0,347606.09, diversi a diversi,,,,,
8.04.004,COMPENSI PER CONTRATTI A PROGETTO ,31/08/2021,150,RETRIBUZ.OMEGA AGOS, ,31/08/2021, ,5725.0,353331.09, diversi a diversi,,,,,
8.04.004,COMPENSI PER CONTRATTI A PROGETTO ,31/08/2021,150,RETRIBUZ.ZETA AGOST, ,31/08/2021, ,7800.0,361131.09, diversi a diversi,,,,,
8.04.004,COMPENSI PER CONTRATTI A PROGETTO ,31/08/2021,150,RETRIBUZ.THETA AGOS, ,31/08/2021, ,2920.0,364051.09, diversi a diversi,,,,,
8.04.004,COMPENSI PER CONTRATTI A PROGETTO ,31/08/2021,150,RETRIBUZ.KAPPA AGOS, ,31/08/2021, ,1290.0,365341.09, diversi a diversi,,,,,
8.04.004,COMPENSI PER CONTRATTI A PROGETTO ,31/08/2021,150,RETRIBUZ.IOTA AGOST, ,31/08/2021, ,3620.0,368961.09, diversi a diversi,,,,,
8.04.004,COMPENSI PER CONTRATTI A PROGETTO ,31/08/2021,150,RETRIBUZ.RHO AGOSTO, ,31/08/2021, ,2122.0,371083.09, diversi a diversi,,,,,
8.04.004,COMPENSI PER CONTRATTI A PROGETTO ,30/09/2021,150,RETRIBUZ.ALFA SETTE, ,30/09/2021, ,5745.0,376828.09, diversi a diversi,,,,,
8.04.004,COMPENSI PER CONTRATTI A PROGETTO ,30/09/2021,150,RETRIBUZ.OMEGA SETT, ,30/09/2021, ,5725.0,382553.09, diversi a diversi,,,,,
8.04.004,COMPENSI PER CONTRATTI A PROGETTO ,30/09/2021,150,RETRIBUZ.ZETA SETTE, ,30/09/2021, ,7800.0,390353.09, diversi a diversi,,,,,
8.04.004,COMPENSI PER CONTRATTI A PROGETTO ,30/09/2021,150,RETRIBUZ.THETA SETT, ,30/09/2021, ,2920.0,393273.09, diversi a diversi,,,,,
8.04.004,COMPENSI PER CONTRATTI A PROGETTO ,30/09/2021,150,RETRIBUZ.KAPPA SETT, ,30/09/2021, ,1290.0,394563.09, diversi a diversi,,,,,
8.04.004,COMPENSI PER CONTRATTI A PROGETTO ,30/09/2021,150,RETRIBUZ.IOTA SETTE, ,30/09/2021, ,2063.0,396626.09, diversi a diversi,,,,,
8.04.004,COMPENSI PER CONTRATTI A PROGETTO ,30/09/2021,150,RETRIBUZ.RHO SETTEM, ,30/09/2021, ,2122.0,398748.09, diversi a diversi,,,,,
8.04.004,COMPENSI PER CONTRATTI A PROGETTO ,30/09/2021,150,"RETRIBUZ,BETA SETTE", ,30/09/2021, ,15370.0,414118.09, diversi a diversi,,,,,
8.04.004,COMPENSI PER CONTRATTI A PROGETTO ,31/10/2021,150,RETRIB.ALFA OTTOBRE, ,31/10/2021, ,5745.0,419863.09, diversi a diversi,,,,,
8.04.004,COMPENSI PER CONTRATTI A PROGETTO ,31/10/2021,150,RETRIBUZ.BETA OTTOB, ,31/10/2021, ,15370.0,435233.09, diversi a diversi,,,,,
8.04.004,COMPENSI PER CONTRATTI A PROGETTO ,31/10/2021,150,RETRIBUZ.OMEGA OTTO, ,31/10/2021, ,3582.0,438815.09, diversi a diversi,,,,,
8.04.004,COMPENSI PER CONTRATTI A PROGETTO ,31/10/2021,150,RETRIBUZ.ZETA OTTOB, ,31/10/2021, ,7232.0,446047.09, diversi a diversi,,,,,
8.04.004,COMPENSI PER CONTRATTI A PROGETTO ,31/10/2021,150,RETRIBUZ.KAPPA OTTO, ,31/10/2021, ,1290.0,447337.09, diversi a diversi,,,,,
8.04.004,COMPENSI PER CONTRATTI A PROGETTO ,31/10/2021,150,"RETRIB,IOTA OTTOBRE", ,31/10/2021, ,2063.0,449400.09, diversi a diversi,,,,,
8.04.004,COMPENSI PER CONTRATTI A PROGETTO ,31/10/2021,150,RETRIBUZ.RHO OTTOBR, ,31/10/2021, ,2122.0,451522.09, diversi a diversi,,,,,
8.04.004,COMPENSI PER CONTRATTI A PROGETTO ,31/10/2021,150,RETRIBUZ.THETA OTTO, ,31/10/2021, ,2920.0,454442.09, diversi a diversi,,,,,
8.04.004,COMPENSI PER CONTRATTI A PROGETTO ,30/11/2021,150,RETRIB.ALFA NOVEMBR, ,30/11/2021, ,5745.0,460187.09, diversi a diversi,,,,,
8.04.004,COMPENSI PER CONTRATTI A PROGETTO ,30/11/2021,150,RETRIB.BETA NOVEMBR, ,30/11/2021, ,15370.0,475557.09, diversi a diversi,,,,,
8.04.004,COMPENSI PER CONTRATTI A PROGETTO ,30/11/2021,150,RETRIBUZ.OMEGA NOVE, ,30/11/2021, ,3582.0,479139.09, diversi a diversi,,,,,
8.04.004,COMPENSI PER CONTRATTI A PROGETTO ,30/11/2021,150,RETRIB.THETA NOVEMB, ,30/11/2021, ,2920.0,482059.09, diversi a diversi,,,,,
8.04.004,COMPENSI PER CONTRATTI A PROGETTO ,30/11/2021,150,RETRIBUZ.KAPPA NOVE, ,30/11/2021, ,1290.0,483349.09, diversi a diversi,,,,,
8.04.004,COMPENSI PER CONTRATTI A PROGETTO ,30/11/2021,150,RETRIB.IOTA NOVEMBR, ,30/11/2021, ,2008.0,485357.09, diversi a diversi,,,,,
8.04.004,COMPENSI PER CONTRATTI A PROGETTO ,30/11/2021,150,RETRIBUZ.RHO NOVEMB, ,30/11/2021, ,2122.0,487479.09, diversi a diversi,,,,,
8.04.004,COMPENSI PER CONTRATTI A PROGETTO ,30/11/2021,150,RETRIBUB.ZETA NOVEM, ,30/11/2021, ,9260.0,496739.09, diversi a diversi,,,,,
8.04.004,COMPENSI PER CONTRATTI A PROGETTO ,31/12/2021,150,RETRIBUZ.C10 , ,31/12/2021, ,8788.0,505527.09, diversi a diversi,,,,,
8.04.004,COMPENSI PER CONTRATTI A PROGETTO ,31/12/2021,150,RETRIB.ALFA DICEMBR, ,31/12/2021, ,5745.0,511272.09, diversi a diversi,,,,,
8.04.004,COMPENSI PER CONTRATTI A PROGETTO ,31/12/2021,150,RETRIBUZ.BETA , ,31/12/2021, ,13867.0,525139.0900000001, diversi a diversi,,,,,
8.04.004,COMPENSI PER CONTRATTI A PROGETTO ,31/12/2021,150,RETRIBUZ.OMEGA DICE, ,31/12/2021, ,3582.0,528721.0900000001, diversi a diversi,,,,,
8.04.004,COMPENSI PER CONTRATTI A PROGETTO ,31/12/2021,150,RETRIB.ZETA DICEMBR, ,31/12/2021, ,9260.0,537981.0900000001, diversi a diversi,,,,,
8.04.004,COMPENSI PER CONTRATTI A PROGETTO ,31/12/2021,150,RETRIB.THETA DICEMB, ,31/12/2021, ,5069.0,543050.0900000001, diversi a diversi,,,,,
8.04.004,COMPENSI PER CONTRATTI A PROGETTO ,31/12/2021,150,RETRIBUZ.KAPPA DICE, ,31/12/2021, ,1290.0,544340.0900000001, diversi a diversi,,,,,
8.04.004,COMPENSI PER CONTRATTI A PROGETTO ,31/12/2021,150,RETRIB.IOTA DICEMBR, ,31/12/2021, ,2008.0,546348.0900000001, diversi a diversi,,,,,
8.04.004,COMPENSI PER CONTRATTI A PROGETTO ,31/12/2021,150,RETRIBUZ.RHO DICEMB, ,31/12/2021, ,2122.0,548470.0900000001, diversi a diversi,,,,,
8.04.004,COMPENSI PER CONTRATTI A PROGETTO ,31/12/2021,150,RETRIB.MARRONE STEF, ,31/12/2021, ,5900.0,554370.0900000001, diversi a diversi,,,,,
8.04.004,COMPENSI PER CONTRATTI A PROGETTO ,31/12/2021,150,CO.CO.CO.X ATHENA , ,31/12/2021, ,10225.0,564595.0900000001, diversi a diversi,,,,,
8.04.010,PRESTAZ.OCCASIONALI ,12/01/2021,150,PRESTAZ.PERON , ,12/01/2021, ,2000.0,2000.0,505013 DEBITI X COMPENSI,,,,,
8.04.010,PRESTAZ.OCCASIONALI ,01/04/2021,150,PRESTAZIONE VASSALL, ,01/04/2021, ,2500.0,4500.0,505013 DEBITI X COMPENSI,,,,,
8.04.010,PRESTAZ.OCCASIONALI ,01/04/2021,150,PRESTAZIONE AURELIO, ,01/04/2021, ,2500.0,7000.0,505013 DEBITI X COMPENSI,,,,,
8.04.010,PRESTAZ.OCCASIONALI ,22/06/2021,150,PRESTAZ.ORIGLIA , ,22/06/2021, ,3600.0,10600.0,505013 DEBITI X COMPENSI,,,,,
8.04.010,PRESTAZ.OCCASIONALI ,12/07/2021,150,PRESTAZ.SANTORO , ,12/07/2021, ,5000.0,15600.0,505013 DEBITI X COMPENSI,,,,,
8.04.010,PRESTAZ.OCCASIONALI ,27/07/2021,150,PRESTAZ.LAEZZA , ,27/07/2021, ,3000.0,18600.0,505013 DEBITI X COMPENSI,,,,,
8.04.010,PRESTAZ.OCCASIONALI ,27/09/2021,150,PRESTAZ.INGENITO , ,27/09/2021, ,5000.0,23600.0,505013 DEBITI X COMPENSI,,,,,
8.04.010,PRESTAZ.OCCASIONALI ,27/09/2021,150,PRESTAZ.ZINNO , ,27/09/2021, ,5000.0,28600.0,505013 DEBITI X COMPENSI,,,,,
8.04.010,PRESTAZ.OCCASIONALI ,05/11/2021,150,PRESTAZ.DI SCALA , ,05/11/2021, ,1066.03,29666.03, diversi a diversi,,,,,
8.04.010,PRESTAZ.OCCASIONALI ,03/12/2021,150,PRESTAZ.BETTI , ,03/12/2021, ,5000.0,34666.03,505013 DEBITI X COMPENSI,,,,,
8.04.010,PRESTAZ.OCCASIONALI ,28/12/2021,150,PRESTAZ.CAPUTO , ,28/12/2021, ,3000.0,37666.03,505013 DEBITI X COMPENSI,,,,,
8.04.010,PRESTAZ.OCCASIONALI ,28/12/2021,150,"PRESTAZ,LA CIVITA ", ,28/12/2021, ,5000.0,42666.03,505013 DEBITI X COMPENSI,,,,,
8.04.023,COMPENSO COMPONENTI COLLEGIO SINDACALE ,30/06/2021,135,CONSULENZE CON R/AC,63,03/06/2021,177,3000.0,3000.0,SADCCF STUDIO ASS.DOTT.CO,,,,,
8.04.023,COMPENSO COMPONENTI COLLEGIO SINDACALE ,30/06/2021,135,CONSULENZE CON R/AC,63,03/06/2021,177,120.0,3120.0,SADCCF STUDIO ASS.DOTT.CO,,,,,
8.04.023,COMPENSO COMPONENTI COLLEGIO SINDACALE ,30/06/2021,150,COMPENSO COLL.SINDA, ,30/06/2021, ,3000.0,6120.0, diversi a diversi,,,,,
8.04.023,COMPENSO COMPONENTI COLLEGIO SINDACALE ,30/11/2021,135,CONSULENZE CON R/AC,140,23/11/2021,414,3000.0,9120.0,SADCCF STUDIO ASS.DOTT.CO,,,,,
8.04.023,COMPENSO COMPONENTI COLLEGIO SINDACALE ,30/11/2021,135,CONSULENZE CON R/AC,140,23/11/2021,414,120.0,9240.0,SADCCF STUDIO ASS.DOTT.CO,,,,,
8.04.024,COSTI PER FERIE E PERMESSI NON GODUTI ,31/12/2021,150,FERIE NON GODUTE 20, ,31/12/2021, ,21009.94,21009.94, diversi a diversi,,,,,
8.06.004,CONTRIBUTI PREVIDENZIALI E ASSISTENZIALI ,31/01/2021,150,COMPENSI ALFA GENNA, ,31/01/2021, ,608.08,608.08, diversi a diversi,,,,,
8.06.004,CONTRIBUTI PREVIDENZIALI E ASSISTENZIALI ,31/01/2021,150,RETRIBUZ.OMEGA GENN, ,31/01/2021, ,2155.3,2763.38, diversi a diversi,,,,,
8.06.004,CONTRIBUTI PREVIDENZIALI E ASSISTENZIALI ,31/01/2021,150,RETRIBUZ.KAPPA GENN, ,31/01/2021, ,207.04,2970.42, diversi a diversi,,,,,
8.06.004,CONTRIBUTI PREVIDENZIALI E ASSISTENZIALI ,31/01/2021,150,RETRIBUZ.IOTA GENNA, ,31/01/2021, ,355.3,3325.72, diversi a diversi,,,,,
8.06.004,CONTRIBUTI PREVIDENZIALI E ASSISTENZIALI ,31/01/2021,150,"RETRIBUZ,THETA GENN", ,31/01/2021, ,1738.39,5064.110000000001, diversi a diversi,,,,,
8.06.004,CONTRIBUTI PREVIDENZIALI E ASSISTENZIALI ,31/01/2021,150,"RETRIBUZ,THETA GENN", ,31/01/2021, ,257.64,5321.750000000001, diversi a diversi,,,,,
8.06.004,CONTRIBUTI PREVIDENZIALI E ASSISTENZIALI ,31/01/2021,150,RETRIBUZ.THETA GENN, ,31/01/2021, ,1938.34,7260.090000000001, diversi a diversi,,,,,
8.06.004,CONTRIBUTI PREVIDENZIALI E ASSISTENZIALI ,31/01/2021,150,RETRIBUZ.BETA GENNA, ,31/01/2021, ,1834.38,9094.470000000001, diversi a diversi,,,,,
8.06.004,CONTRIBUTI PREVIDENZIALI E ASSISTENZIALI ,31/01/2021,150,RETRIBUZ.BETA GENNA, ,31/01/2021, ,280.18,9374.650000000001, diversi a diversi,,,,,
8.06.004,CONTRIBUTI PREVIDENZIALI E ASSISTENZIALI ,31/01/2021,150,RETRIBUZ.BETA GENNA, ,31/01/2021, ,5766.24,15140.89, diversi a diversi,,,,,
8.06.004,CONTRIBUTI PREVIDENZIALI E ASSISTENZIALI ,31/01/2021,150,RETRIBUZ.LAMBDA GEN, ,31/01/2021, ,5624.16,20765.05, diversi a diversi,,,,,
8.06.004,CONTRIBUTI PREVIDENZIALI E ASSISTENZIALI ,31/01/2021,150,RETRIBUZ.LAMBDA GEN, ,31/01/2021, ,1231.21,21996.26, diversi a diversi,,,,,
8.06.004,CONTRIBUTI PREVIDENZIALI E ASSISTENZIALI ,16/02/2021,150,ADDEB.RITEN.GENNAIO, ,16/02/2021, ,4021.76,26018.02, diversi a diversi,,,,,
8.06.004,CONTRIBUTI PREVIDENZIALI E ASSISTENZIALI ,28/02/2021,150,RETRIBUZ.ALFA FEBBR, ,28/02/2021, ,608.08,26626.10000000001, diversi a diversi,,,,,
8.06.004,CONTRIBUTI PREVIDENZIALI E ASSISTENZIALI ,28/02/2021,150,"RETRIBUZ,OMEGA FEBB", ,28/02/2021, ,1503.38,28129.48000000001, diversi a diversi,,,,,
8.06.004,CONTRIBUTI PREVIDENZIALI E ASSISTENZIALI ,28/02/2021,150,RETRIBUZ.ZETA , ,28/02/2021, ,167.49,28296.97000000001, diversi a diversi,,,,,
8.06.004,CONTRIBUTI PREVIDENZIALI E ASSISTENZIALI ,28/02/2021,150,"RETRIBUZ,THETA FEBB", ,28/02/2021, ,681.63,28978.60000000001, diversi a diversi,,,,,
8.06.004,CONTRIBUTI PREVIDENZIALI E ASSISTENZIALI ,28/02/2021,150,"RETRIBUZ,THETA FEBB", ,28/02/2021, ,1938.34,30916.94000000001, diversi a diversi,,,,,
8.06.004,CONTRIBUTI PREVIDENZIALI E ASSISTENZIALI ,28/02/2021,150,RERIBUZ.LAMBDA FEBB, ,28/02/2021, ,2227.09,33144.03000000001, diversi a diversi,,,,,
8.06.004,CONTRIBUTI PREVIDENZIALI E ASSISTENZIALI ,28/02/2021,150,RETRIBUZ.KAPPA FEBB, ,28/02/2021, ,501.42,33645.45000000001, diversi a diversi,,,,,
8.06.004,CONTRIBUTI PREVIDENZIALI E ASSISTENZIALI ,28/02/2021,150,RETRIBUZIONI TAU FE, ,28/02/2021, ,727.5,34372.95000000001, diversi a diversi,,,,,
8.06.004,CONTRIBUTI PREVIDENZIALI E ASSISTENZIALI ,28/02/2021,150,RETRIBUZ.IOTA FEBBR, ,28/02/2021, ,355.3,34728.25000000001, diversi a diversi,,,,,
8.06.004,CONTRIBUTI PREVIDENZIALI E ASSISTENZIALI ,28/02/2021,150,"RETRIBUZ,BETA FEBBR", ,28/02/2021, ,719.38,35447.63000000001, diversi a diversi,,,,,
8.06.004,CONTRIBUTI PREVIDENZIALI E ASSISTENZIALI ,28/02/2021,150,"RETRIBUZ,BETA FEBBR", ,28/02/2021, ,3909.14,39356.77000000001, diversi a diversi,,,,,
8.06.004,CONTRIBUTI PREVIDENZIALI E ASSISTENZIALI ,31/03/2021,150,RETRIBUZ.ALFA MARZO, ,31/03/2021, ,207.04,39563.81000000001, diversi a diversi,,,,,
8.06.004,CONTRIBUTI PREVIDENZIALI E ASSISTENZIALI ,31/03/2021,150,RETRIBUZ.OMEGA MARZ, ,31/03/2021, ,1503.38,41067.19000000001, diversi a diversi,,,,,
8.06.004,CONTRIBUTI PREVIDENZIALI E ASSISTENZIALI ,31/03/2021,150,RETRIBUZ.ZETA MARZO, ,31/03/2021, ,706.69,41773.88000000001, diversi a diversi,,,,,
8.06.004,CONTRIBUTI PREVIDENZIALI E ASSISTENZIALI ,31/03/2021,150,RETRIBUZ.THETA MARZ, ,31/03/2021, ,1198.03,42971.91000000001, diversi a diversi,,,,,
8.06.004,CONTRIBUTI PREVIDENZIALI E ASSISTENZIALI ,31/03/2021,150,RETRIBUZ.THETA MARZ, ,31/03/2021, ,1010.18,43982.09000000001, diversi a diversi,,,,,
8.06.004,CONTRIBUTI PREVIDENZIALI E ASSISTENZIALI ,31/03/2021,150,RETRIBUZ.LAMBDA MAR, ,31/03/2021, ,3896.53,47878.62000000001, diversi a diversi,,,,,
8.06.004,CONTRIBUTI PREVIDENZIALI E ASSISTENZIALI ,31/03/2021,150,"RETRIBUZ,KAPPA MARZ", ,31/03/2021, ,502.06,48380.68000000001, diversi a diversi,,,,,
8.06.004,CONTRIBUTI PREVIDENZIALI E ASSISTENZIALI ,31/03/2021,150,RETRIBUZ.TAU MARZO , ,31/03/2021, ,727.5,49108.18000000001, diversi a diversi,,,,,
8.06.004,CONTRIBUTI PREVIDENZIALI E ASSISTENZIALI ,31/03/2021,150,RETRIBUZ.IOTA MARZO, ,31/03/2021, ,355.3,49463.48000000001, diversi a diversi,,,,,
8.06.004,CONTRIBUTI PREVIDENZIALI E ASSISTENZIALI ,31/03/2021,150,RETRIBUZ.BETA MARZO, ,31/03/2021, ,1264.32,50727.80000000001, diversi a diversi,,,,,
8.06.004,CONTRIBUTI PREVIDENZIALI E ASSISTENZIALI ,31/03/2021,150,RETRIBUZ.BETA MARZO, ,31/03/2021, ,3847.54,54575.34000000001, diversi a diversi,,,,,
8.06.004,CONTRIBUTI PREVIDENZIALI E ASSISTENZIALI ,30/04/2021,150,RETRIBUZ.ALFA APRIL, ,30/04/2021, ,207.04,54782.38000000001, diversi a diversi,,,,,
8.06.004,CONTRIBUTI PREVIDENZIALI E ASSISTENZIALI ,30/04/2021,150,RETRIBUZ.BETA APRIL, ,30/04/2021, ,1312.96,56095.34000000001, diversi a diversi,,,,,
8.06.004,CONTRIBUTI PREVIDENZIALI E ASSISTENZIALI ,30/04/2021,150,RETRIBUZ.BETA APRIL, ,30/04/2021, ,3444.46,59539.80000000001, diversi a diversi,,,,,
8.06.004,CONTRIBUTI PREVIDENZIALI E ASSISTENZIALI ,30/04/2021,150,"RETRIBUZ,OMEGA APRI", ,30/04/2021, ,1503.38,61043.18000000001, diversi a diversi,,,,,
8.06.004,CONTRIBUTI PREVIDENZIALI E ASSISTENZIALI ,30/04/2021,150,RETRIBUZIONI ZETA A, ,30/04/2021, ,1207.17,62250.35000000001, diversi a diversi,,,,,
8.06.004,CONTRIBUTI PREVIDENZIALI E ASSISTENZIALI ,30/04/2021,150,RETRIBUZ.THETA APRI, ,30/04/2021, ,1243.98,63494.33000000001, diversi a diversi,,,,,
8.06.004,CONTRIBUTI PREVIDENZIALI E ASSISTENZIALI ,30/04/2021,150,RETRIBUZ.THETA APRI, ,30/04/2021, ,1010.18,64504.51000000001, diversi a diversi,,,,,
8.06.004,CONTRIBUTI PREVIDENZIALI E ASSISTENZIALI ,30/04/2021,150,RETRIBUZ.LAMBDA APR, ,30/04/2021, ,4003.4,68507.91, diversi a diversi,,,,,
8.06.004,CONTRIBUTI PREVIDENZIALI E ASSISTENZIALI ,30/04/2021,150,RETRIBUZ.KAPPA AGOS, ,30/04/2021, ,502.06,69009.97, diversi a diversi,,,,,
8.06.004,CONTRIBUTI PREVIDENZIALI E ASSISTENZIALI ,30/04/2021,150,RETRIBUZ.TAU APRILE, ,30/04/2021, ,1097.64,70107.61, diversi a diversi,,,,,
8.06.004,CONTRIBUTI PREVIDENZIALI E ASSISTENZIALI ,30/04/2021,150,RETRIBUZ.IOTA APRIL, ,30/04/2021, ,782.94,70890.55, diversi a diversi,,,,,
8.06.004,CONTRIBUTI PREVIDENZIALI E ASSISTENZIALI ,31/05/2021,150,RETRIBUZ.ALFA MAGGI, ,31/05/2021, ,113.92,71004.47, diversi a diversi,,,,,
8.06.004,CONTRIBUTI PREVIDENZIALI E ASSISTENZIALI ,31/05/2021,150,RETRIBUZ.OMEGA MAGG, ,31/05/2021, ,817.41,71821.88, diversi a diversi,,,,,
8.06.004,CONTRIBUTI PREVIDENZIALI E ASSISTENZIALI ,31/05/2021,150,RETRIBUZ.ZETA MAGGI, ,31/05/2021, ,1334.86,73156.74, diversi a diversi,,,,,
8.06.004,CONTRIBUTI PREVIDENZIALI E ASSISTENZIALI ,31/05/2021,150,"RETRIBUZ,LAMBDA MAG", ,31/05/2021, ,3896.53,77053.27, diversi a diversi,,,,,
8.06.004,CONTRIBUTI PREVIDENZIALI E ASSISTENZIALI ,31/05/2021,150,RETRIBUZ.KAPPA MAGG, ,31/05/2021, ,408.3,77461.57, diversi a diversi,,,,,
8.06.004,CONTRIBUTI PREVIDENZIALI E ASSISTENZIALI ,31/05/2021,150,RETRIBUZ.TAU MAGGIO, ,31/05/2021, ,1097.64,78559.21, diversi a diversi,,,,,
8.06.004,CONTRIBUTI PREVIDENZIALI E ASSISTENZIALI ,31/05/2021,150,RETRIBUZ.IOTA MAGGI, ,31/05/2021, ,782.94,79342.15000000001, diversi a diversi,,,,,
8.06.004,CONTRIBUTI PREVIDENZIALI E ASSISTENZIALI ,31/05/2021,150,RETRIBUZ.ETA MAGGIO, ,31/05/2021, ,511.15,79853.3, diversi a diversi,,,,,
8.06.004,CONTRIBUTI PREVIDENZIALI E ASSISTENZIALI ,31/05/2021,150,RETRIBUZ.THETA MAGG, ,31/05/2021, ,1231.19,81084.49, diversi a diversi,,,,,
8.06.004,CONTRIBUTI PREVIDENZIALI E ASSISTENZIALI ,31/05/2021,150,RETRIBUZ.THETA MAGG, ,31/05/2021, ,666.34,81750.83, diversi a diversi,,,,,
8.06.004,CONTRIBUTI PREVIDENZIALI E ASSISTENZIALI ,31/05/2021,150,RETRIBUZ.BETA MAGGI, ,31/05/2021, ,1487.98,83238.81, diversi a diversi,,,,,
8.06.004,CONTRIBUTI PREVIDENZIALI E ASSISTENZIALI ,31/05/2021,150,RETRIBUZ.BETA MAGGI, ,31/05/2021, ,3444.46,86683.27, diversi a diversi,,,,,
8.06.004,CONTRIBUTI PREVIDENZIALI E ASSISTENZIALI ,30/06/2021,150,RETRIBUZ.ALFA GIUGN, ,30/06/2021, ,817.41,87500.68000000001, diversi a diversi,,,,,
8.06.004,CONTRIBUTI PREVIDENZIALI E ASSISTENZIALI ,30/06/2021,150,RETRIBU.BETA GIUGNO, ,30/06/2021, ,727.57,88228.25000000001, diversi a diversi,,,,,
8.06.004,CONTRIBUTI PREVIDENZIALI E ASSISTENZIALI ,30/06/2021,150,RETRIBU.BETA GIUGNO, ,30/06/2021, ,3477.77,91706.02000000002, diversi a diversi,,,,,
8.06.004,CONTRIBUTI PREVIDENZIALI E ASSISTENZIALI ,30/06/2021,150,RETRIBUZ.OMEGA GIUG, ,30/06/2021, ,1306.45,93012.47000000002, diversi a diversi,,,,,
8.06.004,CONTRIBUTI PREVIDENZIALI E ASSISTENZIALI ,30/06/2021,150,RETRIBUZ.ZETA GIUGN, ,30/06/2021, ,1336.79,94349.26000000001, diversi a diversi,,,,,
8.06.004,CONTRIBUTI PREVIDENZIALI E ASSISTENZIALI ,30/06/2021,150,"RETRIBUZ,LAMBDA GIU", ,30/06/2021, ,3896.53,98245.79000000001, diversi a diversi,,,,,
8.06.004,CONTRIBUTI PREVIDENZIALI E ASSISTENZIALI ,30/06/2021,150,RETRIBUZ.KAPPA GIUG, ,30/06/2021, ,294.38,98540.17000000001, diversi a diversi,,,,,
8.06.004,CONTRIBUTI PREVIDENZIALI E ASSISTENZIALI ,30/06/2021,150,RETRIBUZ.TAU GIUGNO, ,30/06/2021, ,1097.64,99637.81000000001, diversi a diversi,,,,,
8.06.004,CONTRIBUTI PREVIDENZIALI E ASSISTENZIALI ,30/06/2021,150,"RETRIBUZ,IOTA GIUGN", ,30/06/2021, ,782.94,100420.75, diversi a diversi,,,,,
8.06.004,CONTRIBUTI PREVIDENZIALI E ASSISTENZIALI ,30/06/2021,150,RETRIBUZ.ETA GIUGNO, ,30/06/2021, ,511.15,100931.9, diversi a diversi,,,,,
8.06.004,CONTRIBUTI PREVIDENZIALI E ASSISTENZIALI ,30/06/2021,150,RETRIBUZIONI THETA , ,30/06/2021, ,1298.58,102230.48, diversi a diversi,,,,,
8.06.004,CONTRIBUTI PREVIDENZIALI E ASSISTENZIALI ,30/06/2021,150,RETRIBUZIONI THETA , ,30/06/2021, ,1010.18,103240.66, diversi a diversi,,,,,
8.06.004,CONTRIBUTI PREVIDENZIALI E ASSISTENZIALI ,30/06/2021,150,COMPENSO COLL.SINDA, ,30/06/2021, ,480.0,103720.66, diversi a diversi,,,,,
8.06.004,CONTRIBUTI PREVIDENZIALI E ASSISTENZIALI ,31/07/2021,150,"RETRIBUZ,ALFA LUGLI", ,31/07/2021, ,1311.0,105031.66, diversi a diversi,,,,,
8.06.004,CONTRIBUTI PREVIDENZIALI E ASSISTENZIALI ,31/07/2021,150,RETRIBUZ.OMEGA LUGL, ,31/07/2021, ,1306.45,106338.11, diversi a diversi,,,,,
8.06.004,CONTRIBUTI PREVIDENZIALI E ASSISTENZIALI ,31/07/2021,150,"RETRIBUZ,LAMBDA LUG", ,31/07/2021, ,3810.07,110148.18, diversi a diversi,,,,,
8.06.004,CONTRIBUTI PREVIDENZIALI E ASSISTENZIALI ,31/07/2021,150,RETRIBUZ.KAPPA LUGL, ,31/07/2021, ,294.38,110442.56, diversi a diversi,,,,,
8.06.004,CONTRIBUTI PREVIDENZIALI E ASSISTENZIALI ,31/07/2021,150,RETRIBUZ.TAU LUGLIO, ,31/07/2021, ,328.6,110771.16, diversi a diversi,,,,,
8.06.004,CONTRIBUTI PREVIDENZIALI E ASSISTENZIALI ,31/07/2021,150,RETRIBUZ.IOTA LUGLI, ,31/07/2021, ,355.3,111126.46, diversi a diversi,,,,,
8.06.004,CONTRIBUTI PREVIDENZIALI E ASSISTENZIALI ,31/07/2021,150,RETRIB.ETA LUGLIO , ,31/07/2021, ,516.69,111643.15, diversi a diversi,,,,,
8.06.004,CONTRIBUTI PREVIDENZIALI E ASSISTENZIALI ,31/07/2021,150,RETRIBUZ.RHO LUGLIO, ,31/07/2021, ,339.52,111982.67, diversi a diversi,,,,,
8.06.004,CONTRIBUTI PREVIDENZIALI E ASSISTENZIALI ,31/07/2021,150,RETRIBUZ.BETA LUGLI, ,31/07/2021, ,733.68,112716.35, diversi a diversi,,,,,
8.06.004,CONTRIBUTI PREVIDENZIALI E ASSISTENZIALI ,31/07/2021,150,RETRIBUZ.BETA LUGLI, ,31/07/2021, ,4279.89,116996.24, diversi a diversi,,,,,
8.06.004,CONTRIBUTI PREVIDENZIALI E ASSISTENZIALI ,31/07/2021,150,"RETRIBUZ,ZETA LUGLI", ,31/07/2021, ,1336.79,118333.03, diversi a diversi,,,,,
8.06.004,CONTRIBUTI PREVIDENZIALI E ASSISTENZIALI ,31/07/2021,150,RETRIBUZ.THETA LUGL, ,31/07/2021, ,971.72,119304.75, diversi a diversi,,,,,
8.06.004,CONTRIBUTI PREVIDENZIALI E ASSISTENZIALI ,31/07/2021,150,RETRIB.THETA LUGLIO, ,31/07/2021, ,1477.7,120782.45, diversi a diversi,,,,,
8.06.004,CONTRIBUTI PREVIDENZIALI E ASSISTENZIALI ,31/07/2021,160,COMPENSO MARRONE CO, ,31/07/2021, ,-829.09,119953.36,505004 DEBITI V/COLLABORA,,,,,
8.06.004,CONTRIBUTI PREVIDENZIALI E ASSISTENZIALI ,31/08/2021,150,RETRIBUZIONI ALFA A, ,31/08/2021, ,1311.0,121264.36, diversi a diversi,,,,,
8.06.004,CONTRIBUTI PREVIDENZIALI E ASSISTENZIALI ,31/08/2021,150,RETRIBUZ.BETA AGOST, ,31/08/2021, ,789.93,122054.29, diversi a diversi,,,,,
8.06.004,CONTRIBUTI PREVIDENZIALI E ASSISTENZIALI ,31/08/2021,150,RETRIBUZ.BETA AGOST,8,31/08/2021, ,4711.13,126765.42, diversi a diversi,,,,,
8.06.004,CONTRIBUTI PREVIDENZIALI E ASSISTENZIALI ,31/08/2021,150,RETRIBUZ.OMEGA AGOS, ,31/08/2021, ,1306.45,128071.87, diversi a diversi,,,,,
8.06.004,CONTRIBUTI PREVIDENZIALI E ASSISTENZIALI ,31/08/2021,150,RETRIBUZ.ZETA AGOST, ,31/08/2021, ,1336.79,129408.66, diversi a diversi,,,,,
8.06.004,CONTRIBUTI PREVIDENZIALI E ASSISTENZIALI ,31/08/2021,150,RETRIBUZ.THETA AGOS, ,31/08/2021, ,450.91,129859.57, diversi a diversi,,,,,
8.06.004,CONTRIBUTI PREVIDENZIALI E ASSISTENZIALI ,31/08/2021,150,RETRIBUZ.THETA AGOS, ,31/08/2021, ,666.34,130525.91, diversi a diversi,,,,,
8.06.004,CONTRIBUTI PREVIDENZIALI E ASSISTENZIALI ,31/08/2021,150,RETRIBUZ.LAMBDA AGO, ,31/08/2021, ,4109.48,134635.39, diversi a diversi,,,,,
8.06.004,CONTRIBUTI PREVIDENZIALI E ASSISTENZIALI ,31/08/2021,150,RETRIBUZ.KAPPA AGOS, ,31/08/2021, ,294.38,134929.77, diversi a diversi,,,,,
8.06.004,CONTRIBUTI PREVIDENZIALI E ASSISTENZIALI ,31/08/2021,150,RETRIBUZ.IOTA AGOST, ,31/08/2021, ,685.38,135615.15, diversi a diversi,,,,,
8.06.004,CONTRIBUTI PREVIDENZIALI E ASSISTENZIALI ,31/08/2021,150,RETRIBUZ.ETA AGOSTO, ,31/08/2021, ,556.6,136171.75, diversi a diversi,,,,,
8.06.004,CONTRIBUTI PREVIDENZIALI E ASSISTENZIALI ,31/08/2021,150,RETRIBUZ.RHO AGOSTO, ,31/08/2021, ,339.52,136511.27, diversi a diversi,,,,,
8.06.004,CONTRIBUTI PREVIDENZIALI E ASSISTENZIALI ,30/09/2021,150,RETRIBUZ.ALFA SETTE, ,30/09/2021, ,1311.0,137822.27, diversi a diversi,,,,,
8.06.004,CONTRIBUTI PREVIDENZIALI E ASSISTENZIALI ,30/09/2021,150,RETRIBUZ.OMEGA SETT, ,30/09/2021, ,1306.45,139128.72, diversi a diversi,,,,,
8.06.004,CONTRIBUTI PREVIDENZIALI E ASSISTENZIALI ,30/09/2021,150,RETRIBUZ.ZETA SETTE, ,30/09/2021, ,1336.79,140465.51, diversi a diversi,,,,,
8.06.004,CONTRIBUTI PREVIDENZIALI E ASSISTENZIALI ,30/09/2021,150,RETRIBUZ.THETA SETT, ,30/09/2021, ,418.58,140884.09, diversi a diversi,,,,,
8.06.004,CONTRIBUTI PREVIDENZIALI E ASSISTENZIALI ,30/09/2021,150,RETRIBUZ.THETA SETT, ,30/09/2021, ,666.34,141550.43, diversi a diversi,,,,,
8.06.004,CONTRIBUTI PREVIDENZIALI E ASSISTENZIALI ,30/09/2021,150,RETRIBUZ.LAMBDA SET, ,30/09/2021, ,4027.5,145577.93, diversi a diversi,,,,,
8.06.004,CONTRIBUTI PREVIDENZIALI E ASSISTENZIALI ,30/09/2021,150,RETRIBUZ.KAPPA SETT, ,30/09/2021, ,294.38,145872.31, diversi a diversi,,,,,
8.06.004,CONTRIBUTI PREVIDENZIALI E ASSISTENZIALI ,30/09/2021,150,RETRIBUZ.IOTA SETTE, ,30/09/2021, ,330.08,146202.39, diversi a diversi,,,,,
8.06.004,CONTRIBUTI PREVIDENZIALI E ASSISTENZIALI ,30/09/2021,150,RETRIB.ETA SETTEMBR, ,30/09/2021, ,516.69,146719.08, diversi a diversi,,,,,
8.06.004,CONTRIBUTI PREVIDENZIALI E ASSISTENZIALI ,30/09/2021,150,RETRIBUZ.RHO SETTEM, ,30/09/2021, ,339.52,147058.6, diversi a diversi,,,,,
8.06.004,CONTRIBUTI PREVIDENZIALI E ASSISTENZIALI ,30/09/2021,150,"RETRIBUZ,BETA SETTE", ,30/09/2021, ,1283.87,148342.47, diversi a diversi,,,,,
8.06.004,CONTRIBUTI PREVIDENZIALI E ASSISTENZIALI ,30/09/2021,150,RETRIBUZ.BETA SETTE, ,30/09/2021, ,3507.43,151849.9, diversi a diversi,,,,,
8.06.004,CONTRIBUTI PREVIDENZIALI E ASSISTENZIALI ,31/10/2021,150,RETRIB.ALFA OTTOBRE, ,31/10/2021, ,1311.0,153160.9, diversi a diversi,,,,,
8.06.004,CONTRIBUTI PREVIDENZIALI E ASSISTENZIALI ,31/10/2021,150,RETRIBUZ.BETA OTTOB, ,31/10/2021, ,766.21,153927.11, diversi a diversi,,,,,
8.06.004,CONTRIBUTI PREVIDENZIALI E ASSISTENZIALI ,31/10/2021,150,RETRIBUZ.BETA OTTOB, ,31/10/2021, ,3507.43,157434.54, diversi a diversi,,,,,
8.06.004,CONTRIBUTI PREVIDENZIALI E ASSISTENZIALI ,31/10/2021,150,RETRIBUZ.OMEGA OTTO, ,31/10/2021, ,817.41,158251.95, diversi a diversi,,,,,
8.06.004,CONTRIBUTI PREVIDENZIALI E ASSISTENZIALI ,31/10/2021,150,RETRIBUZ.ZETA OTTOB, ,31/10/2021, ,1207.17,159459.12, diversi a diversi,,,,,
8.06.004,CONTRIBUTI PREVIDENZIALI E ASSISTENZIALI ,31/10/2021,150,RETRIBUZ.LAMBDA OTT, ,31/10/2021, ,3920.54,163379.66, diversi a diversi,,,,,
8.06.004,CONTRIBUTI PREVIDENZIALI E ASSISTENZIALI ,31/10/2021,150,RETRIBUZ.KAPPA OTTO, ,31/10/2021, ,294.38,163674.04, diversi a diversi,,,,,
8.06.004,CONTRIBUTI PREVIDENZIALI E ASSISTENZIALI ,31/10/2021,150,"RETRIB,IOTA OTTOBRE", ,31/10/2021, ,330.08,164004.12, diversi a diversi,,,,,
8.06.004,CONTRIBUTI PREVIDENZIALI E ASSISTENZIALI ,31/10/2021,150,RETRIB.ETA OTTOBRE , ,31/10/2021, ,516.69,164520.81, diversi a diversi,,,,,
8.06.004,CONTRIBUTI PREVIDENZIALI E ASSISTENZIALI ,31/10/2021,150,RETRIBUZ.RHO OTTOBR, ,31/10/2021, ,339.52,164860.33, diversi a diversi,,,,,
8.06.004,CONTRIBUTI PREVIDENZIALI E ASSISTENZIALI ,31/10/2021,150,RETRIBUZ.THETA OTTO, ,31/10/2021, ,767.46,165627.79, diversi a diversi,,,,,
8.06.004,CONTRIBUTI PREVIDENZIALI E ASSISTENZIALI ,31/10/2021,150,RETRIBUZ.THETA OTTO, ,31/10/2021, ,666.34,166294.13, diversi a diversi,,,,,
8.06.004,CONTRIBUTI PREVIDENZIALI E ASSISTENZIALI ,30/11/2021,150,RETRIBUZIONI NOVEMB, ,30/11/2021, ,1311.0,167605.13, diversi a diversi,,,,,
8.06.004,CONTRIBUTI PREVIDENZIALI E ASSISTENZIALI ,30/11/2021,150,RETRIB.BETA NOVEMBR, ,30/11/2021, ,795.59,168400.72, diversi a diversi,,,,,
8.06.004,CONTRIBUTI PREVIDENZIALI E ASSISTENZIALI ,30/11/2021,150,RETRIB.BETA NOVEMBR, ,30/11/2021, ,3507.43,171908.15, diversi a diversi,,,,,
8.06.004,CONTRIBUTI PREVIDENZIALI E ASSISTENZIALI ,30/11/2021,150,RETRIBUZ.OMEGA NOVE, ,30/11/2021, ,817.41,172725.56, diversi a diversi,,,,,
8.06.004,CONTRIBUTI PREVIDENZIALI E ASSISTENZIALI ,30/11/2021,150,RETRIB.THETA NOVEMB, ,30/11/2021, ,666.34,173391.9, diversi a diversi,,,,,
8.06.004,CONTRIBUTI PREVIDENZIALI E ASSISTENZIALI ,30/11/2021,150,"RETRIB,LAMBDA NOVEM", ,30/11/2021, ,4027.63,177419.53, diversi a diversi,,,,,
8.06.004,CONTRIBUTI PREVIDENZIALI E ASSISTENZIALI ,30/11/2021,150,RETRIBUZ.KAPPA NOVE, ,30/11/2021, ,294.38,177713.91, diversi a diversi,,,,,
8.06.004,CONTRIBUTI PREVIDENZIALI E ASSISTENZIALI ,30/11/2021,150,RETRIB.IOTA NOVEMBR, ,30/11/2021, ,321.28,178035.19, diversi a diversi,,,,,
8.06.004,CONTRIBUTI PREVIDENZIALI E ASSISTENZIALI ,30/11/2021,150,RETRIB.ETA NOVEMBRE, ,30/11/2021, ,536.75,178571.94, diversi a diversi,,,,,
8.06.004,CONTRIBUTI PREVIDENZIALI E ASSISTENZIALI ,30/11/2021,150,RETRIBUZ.RHO NOVEMB, ,30/11/2021, ,339.52,178911.46, diversi a diversi,,,,,
8.06.004,CONTRIBUTI PREVIDENZIALI E ASSISTENZIALI ,30/11/2021,150,RETRIBUB.ZETA NOVEM, ,30/11/2021, ,1669.95,180581.41, diversi a diversi,,,,,
8.06.004,CONTRIBUTI PREVIDENZIALI E ASSISTENZIALI ,31/12/2021,150,RETRIBUZ.C10 , ,31/12/2021, ,1406.08,181987.49, diversi a diversi,,,,,
8.06.004,CONTRIBUTI PREVIDENZIALI E ASSISTENZIALI ,31/12/2021,150,RETRIB.ALFA DICEMBR, ,31/12/2021, ,1311.0,183298.49, diversi a diversi,,,,,
8.06.004,CONTRIBUTI PREVIDENZIALI E ASSISTENZIALI ,31/12/2021,150,RETRIBUZ.BETA , ,31/12/2021, ,987.26,184285.75, diversi a diversi,,,,,
8.06.004,CONTRIBUTI PREVIDENZIALI E ASSISTENZIALI ,31/12/2021,150,RETRIBUZ.BETA , ,31/12/2021, ,3164.44,187450.19, diversi a diversi,,,,,
8.06.004,CONTRIBUTI PREVIDENZIALI E ASSISTENZIALI ,31/12/2021,150,RETRIBUZ.OMEGA DICE, ,31/12/2021, ,817.41,188267.6, diversi a diversi,,,,,
8.06.004,CONTRIBUTI PREVIDENZIALI E ASSISTENZIALI ,31/12/2021,150,RETRIB.ZETA DICEMBR, ,31/12/2021, ,1669.95,189937.55, diversi a diversi,,,,,
8.06.004,CONTRIBUTI PREVIDENZIALI E ASSISTENZIALI ,31/12/2021,150,RETRIB.THETA DICEMB, ,31/12/2021, ,1010.18,190947.73, diversi a diversi,,,,,
8.06.004,CONTRIBUTI PREVIDENZIALI E ASSISTENZIALI ,31/12/2021,150,RETRIB.LAMBDA DICEM, ,31/12/2021, ,11286.39,202234.12, diversi a diversi,,,,,
8.06.004,CONTRIBUTI PREVIDENZIALI E ASSISTENZIALI ,31/12/2021,150,RETRIBUZ.KAPPA DICE, ,31/12/2021, ,294.38,202528.5, diversi a diversi,,,,,
8.06.004,CONTRIBUTI PREVIDENZIALI E ASSISTENZIALI ,31/12/2021,150,RETRIB.IOTA DICEMBR, ,31/12/2021, ,321.28,202849.78, diversi a diversi,,,,,
8.06.004,CONTRIBUTI PREVIDENZIALI E ASSISTENZIALI ,31/12/2021,150,RETRIBUZ.ETA DICEMB, ,31/12/2021, ,881.22,203731.0, diversi a diversi,,,,,
8.06.004,CONTRIBUTI PREVIDENZIALI E ASSISTENZIALI ,31/12/2021,150,RETRIBUZ.RHO DICEMB, ,31/12/2021, ,339.52,204070.52, diversi a diversi,,,,,
8.06.008,CONTRIBUTI PREVID. SU FERIE E PERMESSI NON GODUTI ,31/12/2021,150,FERIE NON GODUTE 20, ,31/12/2021, ,4185.18,4185.18, diversi a diversi,,,,,
8.07.000,TRATTAMENTO DI FINE RAPPORTO ,31/05/2021,150,EROGATO TFR THETA , ,31/05/2021, ,147.0,147.0, diversi a diversi,,,,,
8.07.000,TRATTAMENTO DI FINE RAPPORTO ,31/05/2021,150,EROGATO TFR BETA , ,31/05/2021, ,985.37,1132.37, diversi a diversi,,,,,
8.07.000,TRATTAMENTO DI FINE RAPPORTO ,30/06/2021,150,EROGATO TFR , ,30/06/2021, ,831.25,1963.62, diversi a diversi,,,,,
8.07.000,TRATTAMENTO DI FINE RAPPORTO ,31/07/2021,150,EROGATO TFR , ,31/07/2021, ,928.51,2892.13, diversi a diversi,,,,,
8.07.000,TRATTAMENTO DI FINE RAPPORTO ,30/09/2021,150,EROGATO TFR , ,30/09/2021, ,2538.03,5430.16, diversi a diversi,,,,,
8.07.000,TRATTAMENTO DI FINE RAPPORTO ,31/10/2021,150,EROGATO TFR , ,31/10/2021, ,1552.25,6982.41, diversi a diversi,,,,,
8.07.000,TRATTAMENTO DI FINE RAPPORTO ,31/12/2021,150,RETRIBUZ.ETA DICEMB, ,31/12/2021, ,1503.59,8486.0, diversi a diversi,,,,,
8.07.000,TRATTAMENTO DI FINE RAPPORTO ,31/12/2021,150,ACC.TO TFR 2021 , ,31/12/2021, ,23163.3,31649.3,605000 FONDO TRATTAMENTO,,,,,
8.08.000,ONERI DIVERSI RELATIVI AL PERSONALE ,30/04/2021,199,ACQUISTI REVERSE CH,M44259 ,07/04/2021,110,1294.99,1294.99,EDENRE EDENRED ITALIA Srl,,,,,
8.08.000,ONERI DIVERSI RELATIVI AL PERSONALE ,31/07/2021,199,ACQUISTI REVERSE CH,M46725 ,27/07/2021,255,1661.91,2956.9,EDENRE EDENRED ITALIA Srl,,,,,
8.08.000,ONERI DIVERSI RELATIVI AL PERSONALE ,20/12/2021,199,ACQUISTI REVERSE CH,M50206 ,13/12/2021,456,1834.57,4791.47,EDENRE EDENRED ITALIA Srl,,,,,
8.08.000,ONERI DIVERSI RELATIVI AL PERSONALE ,20/12/2021,100,FATTURA DI ACQUISTO,16627,18/12/2021,458,4791.47,9582.94,AMAEU Amazon EU S.a r.l.,,,,,
8.09.005,COMPENSI PER PREST.SERVIZI DI TERZI ,31/01/2021,199,ACQUISTI REVERSE CH,15431,05/01/2021,10,13.02,13.02,BANEMI BPER BANCA S.P.A.,,,,,
8.09.005,COMPENSI PER PREST.SERVIZI DI TERZI ,31/01/2021,199,ACQUISTI REVERSE CH,49,21/01/2021,15,28.99,42.01,TECRAI Aruba S.p.A.,,,,,
8.09.005,COMPENSI PER PREST.SERVIZI DI TERZI ,31/01/2021,199,ACQUISTI REVERSE CH,4336,19/01/2021,16,50.0,92.00999999999999,MESSAG MESSAGENET S.R.L.,,,,,
8.09.005,COMPENSI PER PREST.SERVIZI DI TERZI ,31/01/2021,199,ACQUISTI REVERSE CH,2021/44,30/01/2021,26,34.43,126.44,ALGEN ALGEN S.R.L.,,,,,
8.09.005,COMPENSI PER PREST.SERVIZI DI TERZI ,28/02/2021,199,ACQUISTI REVERSE CH,FPR7/21,31/01/2021,39,250.0,376.44,NUOQUA NUOVA QUADRIFOGLIO,,,,,
8.09.005,COMPENSI PER PREST.SERVIZI DI TERZI ,28/02/2021,199,ACQUISTI REVERSE CH,329,31/01/2021,40,35.99,412.43,TECRAI Aruba S.p.A.,,,,,
8.09.005,COMPENSI PER PREST.SERVIZI DI TERZI ,28/02/2021,199,ACQUISTI REVERSE CH,FPR1/21,11/02/2021,44,15200.0,15612.43,EFAIST EFAISTOS S.R.L.,,,,,
8.09.005,COMPENSI PER PREST.SERVIZI DI TERZI ,28/02/2021,199,ACQUISTI REVERSE CH,14,31/01/2021,49,14.44,15626.87,SMARTP SMART PIU' S.R.L.,,,,,
8.09.005,COMPENSI PER PREST.SERVIZI DI TERZI ,28/02/2021,199,ACQUISTI REVERSE CH,22351,20/02/2021,54,13.02,15639.89,BANEMI BPER BANCA S.P.A.,,,,,
8.09.005,COMPENSI PER PREST.SERVIZI DI TERZI ,31/03/2021,199,ACQUISTI REVERSE CH,113,28/02/2021,72,116.37,15756.26,ALGEN ALGEN S.R.L.,,,,,
8.09.005,COMPENSI PER PREST.SERVIZI DI TERZI ,31/03/2021,199,ACQUISTI REVERSE CH,747,28/02/2021,74,15.8,15772.06,TECRAI Aruba S.p.A.,,,,,
8.09.005,COMPENSI PER PREST.SERVIZI DI TERZI ,31/03/2021,199,ACQUISTI REVERSE CH,FPR58 ,10/03/2021,82,250.0,16022.06,NUOQUA NUOVA QUADRIFOGLIO,,,,,
8.09.005,COMPENSI PER PREST.SERVIZI DI TERZI ,31/03/2021,199,ACQUISTI REVERSE CH,30547,02/03/2021,83,13.02,16035.08,BANEMI BPER BANCA S.P.A.,,,,,
8.09.005,COMPENSI PER PREST.SERVIZI DI TERZI ,30/04/2021,199,ACQUISTI REVERSE CH,223,31/03/2021,106,10.65,16045.73,ALGEN ALGEN S.R.L.,,,,,
8.09.005,COMPENSI PER PREST.SERVIZI DI TERZI ,30/04/2021,199,ACQUISTI REVERSE CH,1197,31/03/2021,109,95.89,16141.62,TECRAI Aruba S.p.A.,,,,,
8.09.005,COMPENSI PER PREST.SERVIZI DI TERZI ,30/04/2021,199,ACQUISTI REVERSE CH,FPR71 ,31/03/2021,111,250.0,16391.62,NUOQUA NUOVA QUADRIFOGLIO,,,,,
8.09.005,COMPENSI PER PREST.SERVIZI DI TERZI ,30/04/2021,199,ACQUISTI REVERSE CH,FPR71 ,31/03/2021,111,50.0,16441.62,NUOQUA NUOVA QUADRIFOGLIO,,,,,
8.09.005,COMPENSI PER PREST.SERVIZI DI TERZI ,30/04/2021,199,ACQUISTI REVERSE CH,102,31/03/2021,116,4.98,16446.6,SMARTP SMART PIU' S.R.L.,,,,,
8.09.005,COMPENSI PER PREST.SERVIZI DI TERZI ,30/04/2021,199,ACQUISTI REVERSE CH,39803,02/04/2021,117,13.02,16459.62,BANEMI BPER BANCA S.P.A.,,,,,
8.09.005,COMPENSI PER PREST.SERVIZI DI TERZI ,31/05/2021,199,ACQUISTI REVERSE CH,302,30/04/2021,144,204.92,16664.54,ALGEN ALGEN S.R.L.,,,,,
8.09.005,COMPENSI PER PREST.SERVIZI DI TERZI ,31/05/2021,199,ACQUISTI REVERSE CH,138,30/04/2021,152,5.0,16669.54,SMARTP SMART PIU' S.R.L.,,,,,
8.09.005,COMPENSI PER PREST.SERVIZI DI TERZI ,31/05/2021,199,ACQUISTI REVERSE CH,FPR115 ,14/05/2021,154,200.0,16869.54,NUOQUA NUOVA QUADRIFOGLIO,,,,,
8.09.005,COMPENSI PER PREST.SERVIZI DI TERZI ,31/05/2021,199,ACQUISTI REVERSE CH,FPR115 ,14/05/2021,154,61.0,16930.54,NUOQUA NUOVA QUADRIFOGLIO,,,,,
8.09.005,COMPENSI PER PREST.SERVIZI DI TERZI ,31/05/2021,199,ACQUISTI REVERSE CH,3FE ,14/05/2021,158,200.0,17130.54,SPICIS SPICI SRL - SOC. P,,,,,
8.09.005,COMPENSI PER PREST.SERVIZI DI TERZI ,31/05/2021,199,ACQUISTI REVERSE CH,49781,04/05/2021,160,13.02,17143.56,BANEMI BPER BANCA S.P.A.,,,,,
8.09.005,COMPENSI PER PREST.SERVIZI DI TERZI ,31/05/2021,40104,ACQUISTO MERCI NO R,89214,31/05/2021,169,1.01,17144.57, diversi a diversi,,,,,
8.09.005,COMPENSI PER PREST.SERVIZI DI TERZI ,30/06/2021,199,ACQUISTI REVERSE CH,355,31/05/2021,176,305.74,17450.31,ALGEN ALGEN S.R.L.,,,,,
8.09.005,COMPENSI PER PREST.SERVIZI DI TERZI ,30/06/2021,199,ACQUISTI REVERSE CH,78018,31/05/2021,179,36.47,17486.78,SIAD S.I.A.D. S.P.A.,,,,,
8.09.005,COMPENSI PER PREST.SERVIZI DI TERZI ,30/06/2021,199,ACQUISTI REVERSE CH,206,31/05/2021,186,165.05,17651.83,SMARTP SMART PIU' S.R.L.,,,,,
8.09.005,COMPENSI PER PREST.SERVIZI DI TERZI ,30/06/2021,199,ACQUISTI REVERSE CH,FPR133 ,14/06/2021,187,250.0,17901.83,NUOQUA NUOVA QUADRIFOGLIO,,,,,
8.09.005,COMPENSI PER PREST.SERVIZI DI TERZI ,30/06/2021,199,ACQUISTI REVERSE CH,FPR133 ,14/06/2021,187,50.0,17951.83,NUOQUA NUOVA QUADRIFOGLIO,,,,,
8.09.005,COMPENSI PER PREST.SERVIZI DI TERZI ,30/06/2021,199,ACQUISTI REVERSE CH,62362,03/06/2021,194,13.02,17964.85,BANEMI BPER BANCA S.P.A.,,,,,
8.09.005,COMPENSI PER PREST.SERVIZI DI TERZI ,30/06/2021,40104,ACQUISTO MERCI NO R,78518,30/06/2021,203,6.73,17971.58, diversi a diversi,,,,,
8.09.005,COMPENSI PER PREST.SERVIZI DI TERZI ,31/07/2021,199,ACQUISTI REVERSE CH,437,30/06/2021,218,53.29,18024.87,ALGEN ALGEN S.R.L.,,,,,
8.09.005,COMPENSI PER PREST.SERVIZI DI TERZI ,31/07/2021,199,ACQUISTI REVERSE CH,161,05/07/2021,221,250.0,18274.87,NUOQUA NUOVA QUADRIFOGLIO,,,,,
8.09.005,COMPENSI PER PREST.SERVIZI DI TERZI ,31/07/2021,199,ACQUISTI REVERSE CH,627/03 ,09/07/2021,229,1538.45,19813.32,LGSOLU L & G SOLUTION SRL,,,,,
8.09.005,COMPENSI PER PREST.SERVIZI DI TERZI ,31/07/2021,199,ACQUISTI REVERSE CH,632/03 ,09/07/2021,230,1538.45,21351.77,LGSOLU L & G SOLUTION SRL,,,,,
8.09.005,COMPENSI PER PREST.SERVIZI DI TERZI ,31/07/2021,199,ACQUISTI REVERSE CH,634/03 ,09/07/2021,231,1538.45,22890.22,LGSOLU L & G SOLUTION SRL,,,,,
8.09.005,COMPENSI PER PREST.SERVIZI DI TERZI ,31/07/2021,199,ACQUISTI REVERSE CH,628/03 ,09/07/2021,232,1561.68,24451.90000000001,LGSOLU L & G SOLUTION SRL,,,,,
8.09.005,COMPENSI PER PREST.SERVIZI DI TERZI ,31/07/2021,199,ACQUISTI REVERSE CH,630/03 ,09/07/2021,233,1561.68,26013.58000000001,LGSOLU L & G SOLUTION SRL,,,,,
8.09.005,COMPENSI PER PREST.SERVIZI DI TERZI ,31/07/2021,199,ACQUISTI REVERSE CH,629/03 ,09/07/2021,234,1584.91,27598.49000000001,LGSOLU L & G SOLUTION SRL,,,,,
8.09.005,COMPENSI PER PREST.SERVIZI DI TERZI ,31/07/2021,199,ACQUISTI REVERSE CH,262,30/06/2021,236,5.05,27603.54,SMARTP SMART PIU' S.R.L.,,,,,
8.09.005,COMPENSI PER PREST.SERVIZI DI TERZI ,31/07/2021,199,ACQUISTI REVERSE CH,631/03 ,09/07/2021,237,1561.68,29165.22,LGSOLU L & G SOLUTION SRL,,,,,
8.09.005,COMPENSI PER PREST.SERVIZI DI TERZI ,31/07/2021,199,ACQUISTI REVERSE CH,633/03 ,09/07/2021,238,1538.45,30703.67000000001,LGSOLU L & G SOLUTION SRL,,,,,
8.09.005,COMPENSI PER PREST.SERVIZI DI TERZI ,31/07/2021,199,ACQUISTI REVERSE CH,79748,02/07/2021,239,13.02,30716.69000000001,BANEMI BPER BANCA S.P.A.,,,,,
8.09.005,COMPENSI PER PREST.SERVIZI DI TERZI ,31/07/2021,199,ACQUISTI REVERSE CH,741/03 ,27/07/2021,254,1631.37,32348.06,LGSOLU L & G SOLUTION SRL,,,,,
8.09.005,COMPENSI PER PREST.SERVIZI DI TERZI ,31/07/2021,40100,FATTURA DI ACQUISTO,41323,31/07/2021,263,6.73,32354.79, diversi a diversi,,,,,
8.09.005,COMPENSI PER PREST.SERVIZI DI TERZI ,31/08/2021,199,ACQUISTI REVERSE CH,FPR191 ,31/07/2021,265,200.0,32554.79,NUOQUA NUOVA QUADRIFOGLIO,,,,,
8.09.005,COMPENSI PER PREST.SERVIZI DI TERZI ,31/08/2021,199,ACQUISTI REVERSE CH,FPR191 ,31/07/2021,265,61.0,32615.79,NUOQUA NUOVA QUADRIFOGLIO,,,,,
8.09.005,COMPENSI PER PREST.SERVIZI DI TERZI ,31/08/2021,199,ACQUISTI REVERSE CH,522,31/07/2021,269,15.84,32631.63,ALGEN ALGEN S.R.L.,,,,,
8.09.005,COMPENSI PER PREST.SERVIZI DI TERZI ,31/08/2021,199,ACQUISTI REVERSE CH,287,31/07/2021,276,31.31,32662.94000000001,SMARTP SMART PIU' S.R.L.,,,,,
8.09.005,COMPENSI PER PREST.SERVIZI DI TERZI ,31/08/2021,199,ACQUISTI REVERSE CH,99165,04/08/2021,278,13.02,32675.96000000001,BANEMI BPER BANCA S.P.A.,,,,,
8.09.005,COMPENSI PER PREST.SERVIZI DI TERZI ,31/08/2021,40104,ACQUISTO MERCI NO R,94200,31/08/2021,281,6.73,32682.69000000001, diversi a diversi,,,,,
8.09.005,COMPENSI PER PREST.SERVIZI DI TERZI ,23/09/2021,199,ACQUISTI REVERSE CH,918776,07/09/2021,289,13.02,32695.71000000001,BANEMI BPER BANCA S.P.A.,,,,,
8.09.005,COMPENSI PER PREST.SERVIZI DI TERZI ,30/09/2021,199,ACQUISTI REVERSE CH,FPR232 ,24/09/2021,296,250.0,32945.71000000001,NUOQUA NUOVA QUADRIFOGLIO,,,,,
8.09.005,COMPENSI PER PREST.SERVIZI DI TERZI ,30/09/2021,199,ACQUISTI REVERSE CH,FPR232 ,24/09/2021,296,100.0,33045.71000000001,NUOQUA NUOVA QUADRIFOGLIO,,,,,
8.09.005,COMPENSI PER PREST.SERVIZI DI TERZI ,30/09/2021,199,ACQUISTI REVERSE CH,FPR3/21,29/09/2021,299,22800.0,55845.71000000001,EFAIST EFAISTOS S.R.L.,,,,,
8.09.005,COMPENSI PER PREST.SERVIZI DI TERZI ,30/09/2021,40104,ACQUISTO MERCI NO R,86868,30/09/2021,303,6.9,55852.61000000001, diversi a diversi,,,,,
8.09.005,COMPENSI PER PREST.SERVIZI DI TERZI ,31/10/2021,199,ACQUISTI REVERSE CH,921/03 ,30/09/2021,305,1584.91,57437.52000000001,LGSOLU L & G SOLUTION SRL,,,,,
8.09.005,COMPENSI PER PREST.SERVIZI DI TERZI ,31/10/2021,199,ACQUISTI REVERSE CH,920/03 ,30/09/2021,306,1584.91,59022.43000000001,LGSOLU L & G SOLUTION SRL,,,,,
8.09.005,COMPENSI PER PREST.SERVIZI DI TERZI ,31/10/2021,199,ACQUISTI REVERSE CH,919/03 ,30/09/2021,307,1584.91,60607.34000000002,LGSOLU L & G SOLUTION SRL,,,,,
8.09.005,COMPENSI PER PREST.SERVIZI DI TERZI ,31/10/2021,199,ACQUISTI REVERSE CH,922/03 ,30/09/2021,309,1584.91,62192.25000000002,LGSOLU L & G SOLUTION SRL,,,,,
8.09.005,COMPENSI PER PREST.SERVIZI DI TERZI ,31/10/2021,199,ACQUISTI REVERSE CH,622,30/09/2021,312,13.94,62206.19000000002,ALGEN ALGEN S.R.L.,,,,,
8.09.005,COMPENSI PER PREST.SERVIZI DI TERZI ,31/10/2021,199,ACQUISTI REVERSE CH,936/03 ,30/09/2021,314,1561.68,63767.87000000002,LGSOLU L & G SOLUTION SRL,,,,,
8.09.005,COMPENSI PER PREST.SERVIZI DI TERZI ,31/10/2021,199,ACQUISTI REVERSE CH,935/03 ,30/09/2021,315,1584.91,65352.78000000003,LGSOLU L & G SOLUTION SRL,,,,,
8.09.005,COMPENSI PER PREST.SERVIZI DI TERZI ,31/10/2021,199,ACQUISTI REVERSE CH,932/03 ,30/09/2021,316,1584.91,66937.69000000003,LGSOLU L & G SOLUTION SRL,,,,,
8.09.005,COMPENSI PER PREST.SERVIZI DI TERZI ,31/10/2021,199,ACQUISTI REVERSE CH,933/03 ,30/09/2021,317,1584.91,68522.60000000003,LGSOLU L & G SOLUTION SRL,,,,,
8.09.005,COMPENSI PER PREST.SERVIZI DI TERZI ,31/10/2021,199,ACQUISTI REVERSE CH,3252,30/09/2021,318,14.99,68537.59000000004,TECRAI Aruba S.p.A.,,,,,
8.09.005,COMPENSI PER PREST.SERVIZI DI TERZI ,31/10/2021,199,ACQUISTI REVERSE CH,41200,04/10/2021,338,13.02,68550.61000000004,BANEMI BPER BANCA S.P.A.,,,,,
8.09.005,COMPENSI PER PREST.SERVIZI DI TERZI ,31/10/2021,199,ACQUISTI REVERSE CH,102393,19/10/2021,341,1900.0,70450.61000000004,ASACER ASACERT ASSESSMENT,,,,,
8.09.005,COMPENSI PER PREST.SERVIZI DI TERZI ,31/10/2021,199,ACQUISTI REVERSE CH,3538,22/10/2021,354,11.99,70462.60000000005,TECRAI Aruba S.p.A.,,,,,
8.09.005,COMPENSI PER PREST.SERVIZI DI TERZI ,31/10/2021,40104,ACQUISTO MERCI NO R,94322,31/10/2021,363,6.93,70469.53000000004, diversi a diversi,,,,,
8.09.005,COMPENSI PER PREST.SERVIZI DI TERZI ,31/10/2021,199,ACQUISTI REVERSE CH,247,25/10/2021,355,250.0,70719.53000000004,NUOQUA NUOVA QUADRIFOGLIO,,,,,
8.09.005,COMPENSI PER PREST.SERVIZI DI TERZI ,30/11/2021,199,ACQUISTI REVERSE CH,702,02/11/2021,379,23.81,70743.34000000004,ALGEN ALGEN S.R.L.,,,,,
8.09.005,COMPENSI PER PREST.SERVIZI DI TERZI ,30/11/2021,199,ACQUISTI REVERSE CH,FPR276 ,08/11/2021,389,250.0,70993.34000000004,NUOQUA NUOVA QUADRIFOGLIO,,,,,
8.09.005,COMPENSI PER PREST.SERVIZI DI TERZI ,30/11/2021,199,ACQUISTI REVERSE CH,FPR276 ,08/11/2021,389,89.0,71082.34000000004,NUOQUA NUOVA QUADRIFOGLIO,,,,,
8.09.005,COMPENSI PER PREST.SERVIZI DI TERZI ,30/11/2021,199,ACQUISTI REVERSE CH,380,30/10/2021,401,34.07,71116.41000000005,SMARTP SMART PIU' S.R.L.,,,,,
8.09.005,COMPENSI PER PREST.SERVIZI DI TERZI ,30/11/2021,199,ACQUISTI REVERSE CH,65670,03/11/2021,402,13.02,71129.43000000005,BANEMI BPER BANCA S.P.A.,,,,,
8.09.005,COMPENSI PER PREST.SERVIZI DI TERZI ,30/11/2021,100,FATTURA DI ACQUISTO,FPR203 ,25/11/2021,415,10000.0,81129.43000000005,OMNESB omnes broker srls,,,,,
8.09.005,COMPENSI PER PREST.SERVIZI DI TERZI ,30/11/2021,100,FATTURA DI ACQUISTO,207,30/11/2021,424,750.0,81879.43000000005,OMNESB omnes broker srls,,,,,
8.09.005,COMPENSI PER PREST.SERVIZI DI TERZI ,30/11/2021,179,ACQUISTI ART. 17 va,3767,10/06/2021,440,754.07,82633.50000000006,FORJOU FORTUNE JOURNALS,,,,,
8.09.005,COMPENSI PER PREST.SERVIZI DI TERZI ,30/11/2021,199,ACQUISTI REVERSE CH,49/FE ,17/11/2021,410,21500.0,104133.5000000001,R4I R4I S.R.L.,,,,,
8.09.005,COMPENSI PER PREST.SERVIZI DI TERZI ,30/11/2021,160,"FATTURA R4I COMPET,", ,30/11/2021, ,-9000.0,95133.50000000006,503004 FATTURE DA RICEVER,,,,,
8.09.005,COMPENSI PER PREST.SERVIZI DI TERZI ,20/12/2021,199,ACQUISTI REVERSE CH,738,30/11/2021,444,6.97,95140.47000000006,ALGEN ALGEN S.R.L.,,,,,
8.09.005,COMPENSI PER PREST.SERVIZI DI TERZI ,20/12/2021,199,ACQUISTI REVERSE CH,326,14/12/2021,453,300.0,95440.47000000006,NUOQUA NUOVA QUADRIFOGLIO,,,,,
8.09.005,COMPENSI PER PREST.SERVIZI DI TERZI ,20/12/2021,199,ACQUISTI REVERSE CH,89677,02/12/2021,455,13.02,95453.49000000006,BANEMI BPER BANCA S.P.A.,,,,,
8.09.005,COMPENSI PER PREST.SERVIZI DI TERZI ,20/12/2021,199,ACQUISTI REVERSE CH,1166/03,14/12/2021,457,1701.06,97154.55000000006,LGSOLU L & G SOLUTION SRL,,,,,
8.09.005,COMPENSI PER PREST.SERVIZI DI TERZI ,31/12/2021,199,ACQUISTI REVERSE CH,FPR334 ,27/12/2021,468,300.0,97454.55000000006,NUOQUA NUOVA QUADRIFOGLIO,,,,,
8.09.005,COMPENSI PER PREST.SERVIZI DI TERZI ,31/12/2021,199,ACQUISTI REVERSE CH,98/2021,30/12/2021,469,4000.0,101454.5500000001,WORLDT WORLD TRAVEL BOUTI,,,,,
8.09.005,COMPENSI PER PREST.SERVIZI DI TERZI ,31/12/2021,100,FATTURA DI ACQUISTO,831,30/12/2021,470,40.0,101494.5500000001,ALGEN ALGEN S.R.L.,,,,,
8.09.005,COMPENSI PER PREST.SERVIZI DI TERZI ,31/12/2021,100,FATTURA DI ACQUISTO,831,30/12/2021,470,6.97,101501.5200000001,ALGEN ALGEN S.R.L.,,,,,
8.09.005,COMPENSI PER PREST.SERVIZI DI TERZI ,31/12/2021,40104,ACQUISTO MERCI NO R,86948,30/11/2021,473,6.73,101508.2500000001, diversi a diversi,,,,,
8.09.005,COMPENSI PER PREST.SERVIZI DI TERZI ,31/12/2021,40104,ACQUISTO MERCI NO R,98142,31/12/2021,474,6.73,101514.9800000001, diversi a diversi,,,,,
8.09.005,COMPENSI PER PREST.SERVIZI DI TERZI ,31/12/2021,150,FATT.DA RIC.L&G SOL, ,31/12/2021, ,1561.68,103076.66,503004 FATTURE DA RICEVER,,,,,
8.09.005,COMPENSI PER PREST.SERVIZI DI TERZI ,31/12/2021,150,PRESTAZ.NEXTGEN DA , ,31/12/2021, ,24500.0,127576.66,503004 FATTURE DA RICEVER,,,,,
8.09.005,COMPENSI PER PREST.SERVIZI DI TERZI ,31/12/2021,150,PRESTAZ.TDS DA FATT, ,31/12/2021, ,30000.0,157576.66,503004 FATTURE DA RICEVER,,,,,
8.09.005,COMPENSI PER PREST.SERVIZI DI TERZI ,31/12/2021,150,KRATOS FATT.DA RICE, ,31/12/2021, ,12500.0,170076.66, diversi a diversi,,,,,
8.09.005,COMPENSI PER PREST.SERVIZI DI TERZI ,31/12/2021,150,DATABOOZ-HARD&SOFT , ,31/12/2021, ,83000.0,253076.66, diversi a diversi,,,,,
8.09.005,COMPENSI PER PREST.SERVIZI DI TERZI ,31/12/2021,150,TIWARE , ,31/12/2021, ,131400.0,384476.66, diversi a diversi,,,,,
8.09.005,COMPENSI PER PREST.SERVIZI DI TERZI ,31/12/2021,150,TOP-IN , ,31/12/2021, ,32866.47,417343.13, diversi a diversi,,,,,
8.09.005,COMPENSI PER PREST.SERVIZI DI TERZI ,31/12/2021,150,"FATT,DA RICEV.X ENT", ,31/12/2021, ,50000.0,467343.13, diversi a diversi,,,,,
8.09.020,CONVENZIONE RICERCA E CONSULENZA ,31/07/2021,100,FATTURA DI ACQUISTO,33/FE ,20/07/2021,240,21500.0,21500.0,R4I R4I S.R.L.,,,,,
8.09.020,CONVENZIONE RICERCA E CONSULENZA ,31/07/2021,1100,FATTURA DI ACQUISTO,34/FE ,20/07/2021,241,-21500.0,0.0,R4I R4I S.R.L.,,,,,
8.11.000,MANUTENZIONI E RIPARAZIONI ,31/01/2021,199,ACQUISTI REVERSE CH,40,22/01/2021,14,30.0,30.0,MCSSRL MCS S.R.L.,,,,,
8.11.000,MANUTENZIONI E RIPARAZIONI ,31/03/2021,199,ACQUISTI REVERSE CH,58,09/03/2021,78,70.0,100.0,POLSER POLITECNO SERVICE,,,,,
8.11.000,MANUTENZIONI E RIPARAZIONI ,31/07/2021,199,ACQUISTI REVERSE CH,471,08/07/2021,223,40.0,140.0,MCSSRL MCS S.R.L.,,,,,
8.11.011,MATERIALI DI CONSUMO ,31/01/2021,199,ACQUISTI REVERSE CH,9/PRSP ,29/01/2021,22,371.0,371.0,SIALSR S.I.A.L. SRL,,,,,
8.11.011,MATERIALI DI CONSUMO ,31/01/2021,199,ACQUISTI REVERSE CH,18515,27/01/2021,25,700.0,1071.0,GEHEAL Cytiva Europe GmbH,,,,,
8.11.011,MATERIALI DI CONSUMO ,28/02/2021,40100,FATTURA DI ACQUISTO,31033,08/02/2021,30,381.95,1452.95, diversi a diversi,,,,,
8.11.011,MATERIALI DI CONSUMO ,28/02/2021,199,ACQUISTI REVERSE CH,112,02/02/2021,37,150.0,1602.95,IANCHE IAN CHEM S.R.L. LA,,,,,
8.11.011,MATERIALI DI CONSUMO ,28/02/2021,199,ACQUISTI REVERSE CH,83009,27/01/2021,38,323.88,1926.83,FISHER FISHER SCIENTIFIC,,,,,
8.11.011,MATERIALI DI CONSUMO ,28/02/2021,199,ACQUISTI REVERSE CH,FPR7/21,31/01/2021,39,61.0,1987.83,NUOQUA NUOVA QUADRIFOGLIO,,,,,
8.11.011,MATERIALI DI CONSUMO ,28/02/2021,1199,ACQUISTI REVERSE CH,98032,11/02/2021,45,-145.45,1842.38,SIGMAA SIGMA ALDRICH S.R.,,,,,
8.11.011,MATERIALI DI CONSUMO ,28/02/2021,1199,ACQUISTI REVERSE CH,98033,11/02/2021,46,-370.2,1472.18,SIGMAA SIGMA ALDRICH S.R.,,,,,
8.11.011,MATERIALI DI CONSUMO ,28/02/2021,1199,ACQUISTI REVERSE CH,98034,11/02/2021,47,-94.0,1378.18,SIGMAA SIGMA ALDRICH S.R.,,,,,
8.11.011,MATERIALI DI CONSUMO ,28/02/2021,1199,ACQUISTI REVERSE CH,98035,11/02/2021,48,-54.45,1323.73,SIGMAA SIGMA ALDRICH S.R.,,,,,
8.11.011,MATERIALI DI CONSUMO ,28/02/2021,100,FATTURA DI ACQUISTO,98615,12/02/2021,51,1333.1,2656.83,SIGMAA SIGMA ALDRICH S.R.,,,,,
8.11.011,MATERIALI DI CONSUMO ,28/02/2021,2199,ACQUISTI REVERSE CH,98616,12/02/2021,52,664.1,3320.93,SIGMAA SIGMA ALDRICH S.R.,,,,,
8.11.011,MATERIALI DI CONSUMO ,28/02/2021,2199,ACQUISTI REVERSE CH,98617,12/02/2021,53,447.5,3768.43,SIGMAA SIGMA ALDRICH S.R.,,,,,
8.11.011,MATERIALI DI CONSUMO ,28/02/2021,199,ACQUISTI REVERSE CH,516 A ,17/02/2021,57,656.0,4424.43,DBA D.B.A. ITALIA S.R.,,,,,
8.11.011,MATERIALI DI CONSUMO ,28/02/2021,199,ACQUISTI REVERSE CH,526 A ,19/02/2021,58,234.0,4658.43,DBA D.B.A. ITALIA S.R.,,,,,
8.11.011,MATERIALI DI CONSUMO ,28/02/2021,199,ACQUISTI REVERSE CH,62/2021,22/02/2021,60,1731.66,6390.09,DBELE DB ELECTRONIC INST,,,,,
8.11.011,MATERIALI DI CONSUMO ,28/02/2021,100,FATTURA DI ACQUISTO,4/E ,24/02/2021,33,234.0,6624.09,MDMELE MDM ELETTRONICA DI,,,,,
8.11.011,MATERIALI DI CONSUMO ,28/02/2021,100,FATTURA DI ACQUISTO,120,14/01/2021,65,4674.75,11298.84,CRYSTR CRYSTAN LTD,,,,,
8.11.011,MATERIALI DI CONSUMO ,31/03/2021,199,ACQUISTI REVERSE CH,9225,02/03/2021,71,224.4,11523.24,SIGMAA SIGMA ALDRICH S.R.,,,,,
8.11.011,MATERIALI DI CONSUMO ,31/03/2021,199,ACQUISTI REVERSE CH,12373,08/03/2021,80,76.6,11599.84,SIGMAA SIGMA ALDRICH S.R.,,,,,
8.11.011,MATERIALI DI CONSUMO ,31/03/2021,199,ACQUISTI REVERSE CH,30/PRSP,09/03/2021,81,1640.0,13239.84,SIALSR S.I.A.L. SRL,,,,,
8.11.011,MATERIALI DI CONSUMO ,31/03/2021,199,ACQUISTI REVERSE CH,FPR58 ,10/03/2021,82,50.0,13289.84,NUOQUA NUOVA QUADRIFOGLIO,,,,,
8.11.011,MATERIALI DI CONSUMO ,31/03/2021,199,ACQUISTI REVERSE CH,4655/21,15/03/2021,84,254.08,13543.92,PACKSE PACK SERVICES S.R.,,,,,
8.11.011,MATERIALI DI CONSUMO ,31/03/2021,199,ACQUISTI REVERSE CH,4655/21,15/03/2021,84,39.5,13583.42,PACKSE PACK SERVICES S.R.,,,,,
8.11.011,MATERIALI DI CONSUMO ,31/03/2021,199,ACQUISTI REVERSE CH,9770/V1,15/03/2021,85,5.17,13588.59,ELECAM ELETTROCAMPANIA S.,,,,,
8.11.011,MATERIALI DI CONSUMO ,31/03/2021,199,ACQUISTI REVERSE CH,16989,16/03/2021,86,146.0,13734.59,SIGMAA SIGMA ALDRICH S.R.,,,,,
8.11.011,MATERIALI DI CONSUMO ,31/03/2021,199,ACQUISTI REVERSE CH,31/PRSP,17/03/2021,88,945.0,14679.59,SIALSR S.I.A.L. SRL,,,,,
8.11.011,MATERIALI DI CONSUMO ,31/03/2021,199,ACQUISTI REVERSE CH,17796,17/03/2021,89,147.0,14826.59,SIGMAA SIGMA ALDRICH S.R.,,,,,
8.11.011,MATERIALI DI CONSUMO ,31/03/2021,100,FATTURA DI ACQUISTO,6320,16/03/2021,98,274.94,15101.53,BBISOL BBI SOLUTIONS,,,,,
8.11.011,MATERIALI DI CONSUMO ,09/04/2021,150,ADDEB.ACQ.INTERNET , ,09/04/2021, ,55.98,15157.51,102024 BANCA DELLA CAMPAN,,,,,
8.11.011,MATERIALI DI CONSUMO ,09/04/2021,150,ADDEB.ACQ.INTERNET , ,09/04/2021, ,27.99,15185.5,102024 BANCA DELLA CAMPAN,,,,,
8.11.011,MATERIALI DI CONSUMO ,09/04/2021,150,ADDEB.ACQ.INTERNET , ,09/04/2021, ,51.98,15237.48,102024 BANCA DELLA CAMPAN,,,,,
8.11.011,MATERIALI DI CONSUMO ,30/04/2021,199,ACQUISTI REVERSE CH,88671,14/04/2021,118,323.88,15561.36,FISHER FISHER SCIENTIFIC,,,,,
8.11.011,MATERIALI DI CONSUMO ,30/04/2021,1199,ACQUISTI REVERSE CH,88933,16/04/2021,119,-1627.82,13933.54,FISHER FISHER SCIENTIFIC,,,,,
8.11.011,MATERIALI DI CONSUMO ,30/04/2021,199,ACQUISTI REVERSE CH,89008,19/04/2021,120,1627.82,15561.36,FISHER FISHER SCIENTIFIC,,,,,
8.11.011,MATERIALI DI CONSUMO ,30/04/2021,199,ACQUISTI REVERSE CH,105/M ,21/04/2021,130,234.0,15795.36,MORRET MORRETTA FRANCESCO,,,,,
8.11.011,MATERIALI DI CONSUMO ,30/04/2021,199,ACQUISTI REVERSE CH,258/E ,29/04/2021,131,6256.0,22051.36,NANOVI NANOVISION S.R.L.,,,,,
8.11.011,MATERIALI DI CONSUMO ,30/04/2021,199,ACQUISTI REVERSE CH,41602,30/04/2021,132,630.4,22681.76,SIGMAA SIGMA ALDRICH S.R.,,,,,
8.11.011,MATERIALI DI CONSUMO ,30/04/2021,40100,FATTURA DI ACQUISTO,827257,31/03/2021,136,54.0,22735.76, diversi a diversi,,,,,
8.11.011,MATERIALI DI CONSUMO ,30/04/2021,40100,FATTURA DI ACQUISTO,59915,12/04/2021,137,109.78,22845.54, diversi a diversi,,,,,
8.11.011,MATERIALI DI CONSUMO ,31/05/2021,199,ACQUISTI REVERSE CH,36007,30/04/2021,143,86.5,22932.04,VWR VWR INTERNATIONAL,,,,,
8.11.011,MATERIALI DI CONSUMO ,31/05/2021,199,ACQUISTI REVERSE CH,311,30/04/2021,146,180.2,23112.24,OPTOTE OPTOTECH S.R.L.,,,,,
8.11.011,MATERIALI DI CONSUMO ,31/05/2021,199,ACQUISTI REVERSE CH,69/PRSP,04/05/2021,149,910.0,24022.24,SIALSR S.I.A.L. SRL,,,,,
8.11.011,MATERIALI DI CONSUMO ,31/05/2021,1199,ACQUISTI REVERSE CH,04/NC ,12/05/2021,150,-320.0,23702.24,CAPUOZ CAPUOZZO S.R.L.,,,,,
8.11.011,MATERIALI DI CONSUMO ,31/05/2021,199,ACQUISTI REVERSE CH,05/P.A.,12/05/2021,151,320.0,24022.24,CAPUOZ CAPUOZZO S.R.L.,,,,,
8.11.011,MATERIALI DI CONSUMO ,31/05/2021,1199,ACQUISTI REVERSE CH,98036,11/02/2021,155,-37.5,23984.74,SIGMAA SIGMA ALDRICH S.R.,,,,,
8.11.011,MATERIALI DI CONSUMO ,31/05/2021,1199,ACQUISTI REVERSE CH,98037,11/02/2021,156,-410.0,23574.74,SIGMAA SIGMA ALDRICH S.R.,,,,,
8.11.011,MATERIALI DI CONSUMO ,31/05/2021,199,ACQUISTI REVERSE CH,19474,17/05/2021,159,832.2,24406.94,GEHEAL Cytiva Europe GmbH,,,,,
8.11.011,MATERIALI DI CONSUMO ,31/05/2021,199,ACQUISTI REVERSE CH,22474,20/05/2021,161,1237.6,25644.54,SARTO1 Sartorius Italy S.,,,,,
8.11.011,MATERIALI DI CONSUMO ,31/05/2021,199,ACQUISTI REVERSE CH,1286,26/05/2021,167,198.0,25842.54,OPTOTR OPTOTRIM S.R.L.,,,,,
8.11.011,MATERIALI DI CONSUMO ,31/05/2021,40104,ACQUISTO MERCI NO R,10863,12/05/2021,170,520.0,26362.54, diversi a diversi,,,,,
8.11.011,MATERIALI DI CONSUMO ,31/05/2021,40104,ACQUISTO MERCI NO R,2284,05/05/2021,171,1532.5,27895.04, diversi a diversi,,,,,
8.11.011,MATERIALI DI CONSUMO ,31/05/2021,40104,ACQUISTO MERCI NO R,11087,03/05/2021,172,4512.0,32407.04, diversi a diversi,,,,,
8.11.011,MATERIALI DI CONSUMO ,31/05/2021,40104,ACQUISTO MERCI NO R,6265,30/04/2021,173,279.44,32686.48, diversi a diversi,,,,,
8.11.011,MATERIALI DI CONSUMO ,31/05/2021,40104,ACQUISTO MERCI NO R,785,14/05/2021,174,140.04,32826.52, diversi a diversi,,,,,
8.11.011,MATERIALI DI CONSUMO ,30/06/2021,199,ACQUISTI REVERSE CH,14/SP ,31/05/2021,175,19.87,32846.39,SIDSPA SIDERSAN SPA,,,,,
8.11.011,MATERIALI DI CONSUMO ,30/06/2021,199,ACQUISTI REVERSE CH,64882,10/06/2021,184,363.9,33210.29,SIGMAA SIGMA ALDRICH S.R.,,,,,
8.11.011,MATERIALI DI CONSUMO ,30/06/2021,1199,ACQUISTI REVERSE CH,93373,15/06/2021,188,-323.88,32886.41,FISHER FISHER SCIENTIFIC,,,,,
8.11.011,MATERIALI DI CONSUMO ,30/06/2021,199,ACQUISTI REVERSE CH,88/PRSP,15/06/2021,191,205.0,33091.41,SIALSR S.I.A.L. SRL,,,,,
8.11.011,MATERIALI DI CONSUMO ,30/06/2021,1199,ACQUISTI REVERSE CH,93374,15/06/2021,192,-323.88,32767.53,FISHER FISHER SCIENTIFIC,,,,,
8.11.011,MATERIALI DI CONSUMO ,30/06/2021,199,ACQUISTI REVERSE CH,93463,16/06/2021,193,1571.25,34338.78,FISHER FISHER SCIENTIFIC,,,,,
8.11.011,MATERIALI DI CONSUMO ,30/06/2021,199,ACQUISTI REVERSE CH,FPR19 ,22/06/2021,195,1410.0,35748.78,GHT EXGHTP s.r.l. in l,,,,,
8.11.011,MATERIALI DI CONSUMO ,30/06/2021,199,ACQUISTI REVERSE CH,92/PRSP,22/06/2021,196,122.0,35870.78,SIALSR S.I.A.L. SRL,,,,,
8.11.011,MATERIALI DI CONSUMO ,30/06/2021,199,ACQUISTI REVERSE CH,A5882 ,25/06/2021,199,1973.0,37843.78,PRODO1 PRODOTTI GIANNI SR,,,,,
8.11.011,MATERIALI DI CONSUMO ,30/06/2021,199,ACQUISTI REVERSE CH,2042 A ,30/06/2021,200,500.0,38343.78,DBA D.B.A. ITALIA S.R.,,,,,
8.11.011,MATERIALI DI CONSUMO ,30/06/2021,104,ACQUISTO MERCI NO R,85916,13/06/2021,204,2292.83,40636.61,WELLTE WELLTECH INSTRUMEN,,,,,
8.11.011,MATERIALI DI CONSUMO ,30/06/2021,100,FATTURA DI ACQUISTO,51882,28/06/2021,207,2780.63,43417.24,WELLTE WELLTECH INSTRUMEN,,,,,
8.11.011,MATERIALI DI CONSUMO ,30/07/2021,199,ACQUISTI REVERSE CH,18/SP ,30/06/2021,212,171.1,43588.34,SIDSPA SIDERSAN SPA,,,,,
8.11.011,MATERIALI DI CONSUMO ,31/07/2021,199,ACQUISTI REVERSE CH,99238,30/06/2021,216,416.62,44004.96,SIAD S.I.A.D. S.P.A.,,,,,
8.11.011,MATERIALI DI CONSUMO ,31/07/2021,199,ACQUISTI REVERSE CH,4907/V1,02/07/2021,219,21.82,44026.78,ELECAM ELETTROCAMPANIA S.,,,,,
8.11.011,MATERIALI DI CONSUMO ,31/07/2021,199,ACQUISTI REVERSE CH,161,05/07/2021,221,50.0,44076.78,NUOQUA NUOVA QUADRIFOGLIO,,,,,
8.11.011,MATERIALI DI CONSUMO ,31/07/2021,199,ACQUISTI REVERSE CH,78,30/06/2021,224,625.0,44701.78,GENTAU GENTAUR S.R.L. UNI,,,,,
8.11.011,MATERIALI DI CONSUMO ,31/07/2021,199,ACQUISTI REVERSE CH,20011,19/07/2021,244,6118.0,50819.78,GEHEAL Cytiva Europe GmbH,,,,,
8.11.011,MATERIALI DI CONSUMO ,31/07/2021,199,ACQUISTI REVERSE CH,34187,19/07/2021,245,267.0,51086.78,RS RS COMPONENTS S.r.,,,,,
8.11.011,MATERIALI DI CONSUMO ,31/07/2021,199,ACQUISTI REVERSE CH,20033,21/07/2021,246,387.6,51474.38,GEHEAL Cytiva Europe GmbH,,,,,
8.11.011,MATERIALI DI CONSUMO ,31/07/2021,104,ACQUISTO MERCI NO R,3666,27/07/2021,249,389.6,51863.98,SILCAM Silcam Italia S.r.,,,,,
8.11.011,MATERIALI DI CONSUMO ,31/07/2021,1100,FATTURA DI ACQUISTO,48,27/07/2021,250,-389.6,51474.38,SILCAM Silcam Italia S.r.,,,,,
8.11.011,MATERIALI DI CONSUMO ,31/07/2021,199,ACQUISTI REVERSE CH,3668,27/07/2021,251,389.6,51863.98,SILCAM Silcam Italia S.r.,,,,,
8.11.011,MATERIALI DI CONSUMO ,31/07/2021,199,ACQUISTI REVERSE CH,1569,23/07/2021,252,6433.0,58296.98,EOSSRL EOS SRL ELECTRO OP,,,,,
8.11.011,MATERIALI DI CONSUMO ,31/07/2021,40100,FATTURA DI ACQUISTO,775270,30/06/2021,258,54.6,58351.57999999999, diversi a diversi,,,,,
8.11.011,MATERIALI DI CONSUMO ,31/07/2021,40100,FATTURA DI ACQUISTO,75132,02/07/2021,259,1388.0,59739.57999999999, diversi a diversi,,,,,
8.11.011,MATERIALI DI CONSUMO ,31/07/2021,40100,FATTURA DI ACQUISTO,16098,21/07/2021,262,299.54,60039.12, diversi a diversi,,,,,
8.11.011,MATERIALI DI CONSUMO ,31/08/2021,199,ACQUISTI REVERSE CH,8883/V1,30/07/2021,267,186.7,60225.81999999999,ELECAM ELETTROCAMPANIA S.,,,,,
8.11.011,MATERIALI DI CONSUMO ,31/08/2021,199,ACQUISTI REVERSE CH,21/SP ,31/07/2021,268,120.55,60346.37,SIDSPA SIDERSAN SPA,,,,,
8.11.011,MATERIALI DI CONSUMO ,31/08/2021,199,ACQUISTI REVERSE CH,293114,04/08/2021,270,283.0,60629.37,SIGMAA SIGMA ALDRICH S.R.,,,,,
8.11.011,MATERIALI DI CONSUMO ,31/08/2021,1199,ACQUISTI REVERSE CH,858/R1 ,03/08/2021,271,-186.7,60442.67,ELECAM ELETTROCAMPANIA S.,,,,,
8.11.011,MATERIALI DI CONSUMO ,31/08/2021,199,ACQUISTI REVERSE CH,96425,16/08/2021,277,389.2,60831.87,SIGMAA SIGMA ALDRICH S.R.,,,,,
8.11.011,MATERIALI DI CONSUMO ,23/09/2021,199,ACQUISTI REVERSE CH,116,02/09/2021,283,313.0,61144.87,SIALSR S.I.A.L. SRL,,,,,
8.11.011,MATERIALI DI CONSUMO ,23/09/2021,199,ACQUISTI REVERSE CH,FPR23 ,06/09/2021,284,2975.0,64119.87,GHT EXGHTP s.r.l. in l,,,,,
8.11.011,MATERIALI DI CONSUMO ,23/09/2021,199,ACQUISTI REVERSE CH,5\PA/24,07/09/2021,285,113.1,64232.96999999999,CRCSTO C.R.C. STORE S.R.L,,,,,
8.11.011,MATERIALI DI CONSUMO ,23/09/2021,199,ACQUISTI REVERSE CH,A8091 ,08/09/2021,287,640.0,64872.96999999999,PRODO1 PRODOTTI GIANNI SR,,,,,
8.11.011,MATERIALI DI CONSUMO ,23/09/2021,199,ACQUISTI REVERSE CH,3516/V1,13/09/2021,288,14.58,64887.55,ELECAM ELETTROCAMPANIA S.,,,,,
8.11.011,MATERIALI DI CONSUMO ,23/09/2021,199,ACQUISTI REVERSE CH,131,21/09/2021,291,837.0,65724.54999999999,SIALSR S.I.A.L. SRL,,,,,
8.11.011,MATERIALI DI CONSUMO ,30/09/2021,199,ACQUISTI REVERSE CH,570,23/09/2021,293,189.8,65914.34999999999,PERMAX PERMAX SRL,,,,,
8.11.011,MATERIALI DI CONSUMO ,30/09/2021,1110,ACQUISTO IVA N/DETR,FPR231 ,24/09/2021,297,-61.0,65853.34999999999,NUOQUA NUOVA QUADRIFOGLIO,,,,,
8.11.011,MATERIALI DI CONSUMO ,30/09/2021,199,ACQUISTI REVERSE CH,20409,22/09/2021,298,1330.0,67183.34999999999,GEHEAL Cytiva Europe GmbH,,,,,
8.11.011,MATERIALI DI CONSUMO ,30/09/2021,199,ACQUISTI REVERSE CH,4020474,29/09/2021,301,475.0,67658.34999999999,GEHEAL Cytiva Europe GmbH,,,,,
8.11.011,MATERIALI DI CONSUMO ,12/10/2021,150,ADDEV.RICEV.ACQ.ONL, ,12/10/2021, ,105.69,67764.04,102024 BANCA DELLA CAMPAN,,,,,
8.11.011,MATERIALI DI CONSUMO ,31/10/2021,199,ACQUISTI REVERSE CH,1149654,30/09/2021,324,381.25,68145.29,SIAD S.I.A.D. S.P.A.,,,,,
8.11.011,MATERIALI DI CONSUMO ,31/10/2021,199,ACQUISTI REVERSE CH,20504,30/09/2021,325,95.0,68240.29,GEHEAL Cytiva Europe GmbH,,,,,
8.11.011,MATERIALI DI CONSUMO ,31/10/2021,199,ACQUISTI REVERSE CH,19515,06/10/2021,327,342.81,68583.09999999999,SIGMAA SIGMA ALDRICH S.R.,,,,,
8.11.011,MATERIALI DI CONSUMO ,31/10/2021,199,ACQUISTI REVERSE CH,5202740,05/10/2021,328,17.14,68600.23999999999,FARNEL FARNEL ITALIA S.R.,,,,,
8.11.011,MATERIALI DI CONSUMO ,31/10/2021,199,ACQUISTI REVERSE CH,100753,06/10/2021,329,360.08,68960.31999999999,FISHER FISHER SCIENTIFIC,,,,,
8.11.011,MATERIALI DI CONSUMO ,31/10/2021,199,ACQUISTI REVERSE CH,453,01/10/2021,334,201.0,69161.31999999999,TECECO TECNO-ECO S.R.L.,,,,,
8.11.011,MATERIALI DI CONSUMO ,31/10/2021,199,ACQUISTI REVERSE CH,100639,05/10/2021,340,56.2,69217.51999999999,FISHER FISHER SCIENTIFIC,,,,,
8.11.011,MATERIALI DI CONSUMO ,31/10/2021,1199,ACQUISTI REVERSE CH,4020628,18/10/2021,342,-6118.0,63099.51999999999,GEHEAL Cytiva Europe GmbH,,,,,
8.11.011,MATERIALI DI CONSUMO ,31/10/2021,1199,ACQUISTI REVERSE CH,20629,18/10/2021,343,-387.6,62711.91999999999,GEHEAL Cytiva Europe GmbH,,,,,
8.11.011,MATERIALI DI CONSUMO ,31/10/2021,1199,ACQUISTI REVERSE CH,20630,18/10/2021,344,-1330.0,61381.91999999999,GEHEAL Cytiva Europe GmbH,,,,,
8.11.011,MATERIALI DI CONSUMO ,31/10/2021,1199,ACQUISTI REVERSE CH,20631,18/10/2021,345,-475.0,60906.91999999999,GEHEAL Cytiva Europe GmbH,,,,,
8.11.011,MATERIALI DI CONSUMO ,31/10/2021,1199,ACQUISTI REVERSE CH,20632,18/10/2021,346,-95.0,60811.91999999999,GEHEAL Cytiva Europe GmbH,,,,,
8.11.011,MATERIALI DI CONSUMO ,31/10/2021,199,ACQUISTI REVERSE CH,20640,18/10/2021,348,4152.0,64963.91999999999,GEHEAL Cytiva Europe GmbH,,,,,
8.11.011,MATERIALI DI CONSUMO ,31/10/2021,199,ACQUISTI REVERSE CH,20647,18/10/2021,349,8867.3,73831.21999999999,GEHEAL Cytiva Europe GmbH,,,,,
8.11.011,MATERIALI DI CONSUMO ,31/10/2021,199,ACQUISTI REVERSE CH,25568,19/10/2021,350,1377.0,75208.21999999999,SIGMAA SIGMA ALDRICH S.R.,,,,,
8.11.011,MATERIALI DI CONSUMO ,31/10/2021,199,ACQUISTI REVERSE CH,00977/0,15/10/2021,351,288.48,75496.69999999998,DELTEK DELTEK SRL,,,,,
8.11.011,MATERIALI DI CONSUMO ,31/10/2021,199,ACQUISTI REVERSE CH,00977/0,15/10/2021,351,971.74,76468.43999999999,DELTEK DELTEK SRL,,,,,
8.11.011,MATERIALI DI CONSUMO ,31/10/2021,199,ACQUISTI REVERSE CH,58/PRSP,28/10/2021,361,1453.0,77921.43999999999,SIALSR S.I.A.L. SRL,,,,,
8.11.011,MATERIALI DI CONSUMO ,31/10/2021,40104,ACQUISTO MERCI NO R,28289,19/10/2021,364,169.31,78090.74999999999, diversi a diversi,,,,,
8.11.011,MATERIALI DI CONSUMO ,31/10/2021,40104,ACQUISTO MERCI NO R,615597,30/09/2021,365,54.9,78145.64999999998, diversi a diversi,,,,,
8.11.011,MATERIALI DI CONSUMO ,31/10/2021,104,ACQUISTO MERCI NO R,42642,07/10/2021,366,38.37,78184.01999999997,TAGCON TAG CONNECT LLC,,,,,
8.11.011,MATERIALI DI CONSUMO ,31/10/2021,104,ACQUISTO MERCI NO R,8339,20/10/2021,369,490.88,78674.89999999998,BBISOL BBI SOLUTIONS,,,,,
8.11.011,MATERIALI DI CONSUMO ,31/10/2021,104,ACQUISTO MERCI NO R,721002,11/10/2021,372,1045.65,79720.54999999997,CDCREA CREATIVE DIAGNOSTI,,,,,
8.11.011,MATERIALI DI CONSUMO ,31/10/2021,199,ACQUISTI REVERSE CH,247,25/10/2021,355,50.0,79770.54999999997,NUOQUA NUOVA QUADRIFOGLIO,,,,,
8.11.011,MATERIALI DI CONSUMO ,13/11/2021,150,S/RICEV.AMAZON CART, ,12/11/2021, ,9.99,79780.53999999998,102024 BANCA DELLA CAMPAN,,,,,
8.11.011,MATERIALI DI CONSUMO ,30/11/2021,199,ACQUISTI REVERSE CH,92413,31/10/2021,375,320.1,80100.63999999998,VWR VWR INTERNATIONAL,,,,,
8.11.011,MATERIALI DI CONSUMO ,30/11/2021,199,ACQUISTI REVERSE CH,121,02/11/2021,378,600.4,80701.03999999998,HOSMOT HOSMOTIC SRL,,,,,
8.11.011,MATERIALI DI CONSUMO ,30/11/2021,179,ACQUISTI ART. 17 va,1415,30/10/2021,380,7.16,80708.19999999998,EDIBEN EDIL BEN S.R.L.,,,,,
8.11.011,MATERIALI DI CONSUMO ,30/11/2021,199,ACQUISTI REVERSE CH,124,03/11/2021,382,400.0,81108.19999999998,HOSMOT HOSMOTIC SRL,,,,,
8.11.011,MATERIALI DI CONSUMO ,30/11/2021,1199,ACQUISTI REVERSE CH,3,02/11/2021,383,-600.4,80507.79999999999,HOSMOT HOSMOTIC SRL,,,,,
8.11.011,MATERIALI DI CONSUMO ,30/11/2021,199,ACQUISTI REVERSE CH,5290,29/10/2021,384,488.0,80995.79999999999,SPACEI Bio-Techne s.r.l.,,,,,
8.11.011,MATERIALI DI CONSUMO ,30/11/2021,199,ACQUISTI REVERSE CH,66737,31/10/2021,385,99.31,81095.10999999999,SIAD S.I.A.D. S.P.A.,,,,,
8.11.011,MATERIALI DI CONSUMO ,30/11/2021,199,ACQUISTI REVERSE CH,423/04 ,05/11/2021,390,772.0,81867.10999999999,ROBOZE ROBOZE SPA,,,,,
8.11.011,MATERIALI DI CONSUMO ,30/11/2021,199,ACQUISTI REVERSE CH,66/PRSP,09/11/2021,394,252.0,82119.10999999999,SIALSR S.I.A.L. SRL,,,,,
8.11.011,MATERIALI DI CONSUMO ,30/11/2021,1100,FATTURA DI ACQUISTO,337002,10/11/2021,396,-1333.1,80786.00999999998,SIGMAA SIGMA ALDRICH S.R.,,,,,
8.11.011,MATERIALI DI CONSUMO ,30/11/2021,2199,ACQUISTI REVERSE CH,37003,10/11/2021,397,1333.1,82119.10999999999,SIGMAA SIGMA ALDRICH S.R.,,,,,
8.11.011,MATERIALI DI CONSUMO ,30/11/2021,199,ACQUISTI REVERSE CH,37955,11/11/2021,398,368.0,82487.10999999999,SIGMAA SIGMA ALDRICH S.R.,,,,,
8.11.011,MATERIALI DI CONSUMO ,30/11/2021,199,ACQUISTI REVERSE CH,38698,12/11/2021,400,208.8,82695.90999999999,SIGMAA SIGMA ALDRICH S.R.,,,,,
8.11.011,MATERIALI DI CONSUMO ,30/11/2021,199,ACQUISTI REVERSE CH,39390,13/11/2021,403,159.1,82855.01,SIGMAA SIGMA ALDRICH S.R.,,,,,
8.11.011,MATERIALI DI CONSUMO ,30/11/2021,111,BENI STRUMENTALI ,34324,29/10/2021,418,386.23,83241.23999999999,CLICHE CLICK CHEMISTRY TO,,,,,
8.11.011,MATERIALI DI CONSUMO ,30/11/2021,199,ACQUISTI REVERSE CH,A10730 ,30/11/2021,423,4223.0,87464.23999999999,PRODO1 PRODOTTI GIANNI SR,,,,,
8.11.011,MATERIALI DI CONSUMO ,30/11/2021,40104,ACQUISTO MERCI NO R,21955,09/10/2021,432,34.96,87499.2, diversi a diversi,,,,,
8.11.011,MATERIALI DI CONSUMO ,30/11/2021,40104,ACQUISTO MERCI NO R,27535,09/10/2021,433,59.83,87559.03, diversi a diversi,,,,,
8.11.011,MATERIALI DI CONSUMO ,30/11/2021,179,ACQUISTI ART. 17 va,63765,10/11/2021,434,24.4,87583.43,YUHAIT YUHAITENG KEJI YOU,,,,,
8.11.011,MATERIALI DI CONSUMO ,30/11/2021,179,ACQUISTI ART. 17 va,4855,10/10/2021,436,27.86,87611.29,LONGHU LONGHUA XINQU DALA,,,,,
8.11.011,MATERIALI DI CONSUMO ,30/11/2021,179,ACQUISTI ART. 17 va,4852,10/10/2021,435,30.32,87641.61,LONGHU LONGHUA XINQU DALA,,,,,
8.11.011,MATERIALI DI CONSUMO ,30/11/2021,179,ACQUISTI ART. 17 va,7155,09/10/2021,438,32.72,87674.33,GUAHOU GUANGZHOUJIUJINGMA,,,,,
8.11.011,MATERIALI DI CONSUMO ,30/11/2021,179,ACQUISTI ART. 17 va,320,06/02/2020,439,99.96,87774.29000000001,NOOELE NOOLEC INC.,,,,,
8.11.011,MATERIALI DI CONSUMO ,20/12/2021,199,ACQUISTI REVERSE CH,3468 A ,30/11/2021,441,4650.0,92424.29000000001,DBA D.B.A. ITALIA S.R.,,,,,
8.11.011,MATERIALI DI CONSUMO ,20/12/2021,199,ACQUISTI REVERSE CH,84994,30/11/2021,445,301.75,92726.04000000001,SIAD S.I.A.D. S.P.A.,,,,,
8.11.011,MATERIALI DI CONSUMO ,20/12/2021,199,ACQUISTI REVERSE CH,55134,13/12/2021,452,2429.7,95155.74,SIGMAA SIGMA ALDRICH S.R.,,,,,
8.11.011,MATERIALI DI CONSUMO ,31/12/2021,199,ACQUISTI REVERSE CH,650,15/12/2021,460,206.0,95361.74,TECECO TECNO-ECO S.R.L.,,,,,
8.11.011,MATERIALI DI CONSUMO ,31/12/2021,1199,ACQUISTI REVERSE CH,6,15/12/2021,461,-226.0,95135.74,TECECO TECNO-ECO S.R.L.,,,,,
8.11.011,MATERIALI DI CONSUMO ,31/12/2021,1199,ACQUISTI REVERSE CH,359570,22/12/2021,462,-2429.7,92706.04000000001,SIGMAA SIGMA ALDRICH S.R.,,,,,
8.11.011,MATERIALI DI CONSUMO ,31/12/2021,2199,ACQUISTI REVERSE CH,359571,22/12/2021,463,2429.7,95135.74,SIGMAA SIGMA ALDRICH S.R.,,,,,
8.11.011,MATERIALI DI CONSUMO ,31/12/2021,199,ACQUISTI REVERSE CH,787/21 ,30/12/2021,471,891.02,96026.76000000001,NOINTE NOVA INFORMATION T,,,,,
8.11.011,MATERIALI DI CONSUMO ,31/12/2021,40100,FATTURA DI ACQUISTO,57872,01/12/2021,472,210.5,96237.26000000001, diversi a diversi,,,,,
8.11.011,MATERIALI DI CONSUMO ,31/12/2021,40100,FATTURA DI ACQUISTO,109698,13/04/2021,475,115.91,96353.17000000001, diversi a diversi,,,,,
8.11.011,MATERIALI DI CONSUMO ,31/12/2021,150,ACQ.AMAZON-FATT.DA , ,31/12/2021, ,14.32,96367.49000000002,503004 FATTURE DA RICEVER,,,,,
8.11.011,MATERIALI DI CONSUMO ,31/12/2021,150,FATT.DA RICEV.BIO-T, ,31/12/2021, ,1596.0,97963.49000000002,503004 FATTURE DA RICEVER,,,,,
8.11.011,MATERIALI DI CONSUMO ,31/12/2021,160,N.C. DA RICEV.MERCK, ,31/12/2021, ,-283.0,97680.49000000002,208004 FORNIT.C/CREDITI N,,,,,
8.11.011,MATERIALI DI CONSUMO ,31/12/2021,160,N.C. DA RICEV. MERC, ,31/12/2021, ,-146.0,97534.49000000002,208004 FORNIT.C/CREDITI N,,,,,
8.11.011,MATERIALI DI CONSUMO ,31/12/2021,160,N.C. DA RICEV.MERCK, ,31/12/2021, ,-147.0,97387.49000000002,208004 FORNIT.C/CREDITI N,,,,,
8.11.011,MATERIALI DI CONSUMO ,31/12/2021,160,N.C. DA RICEV.MERCK, ,31/12/2021, ,-76.6,97310.89000000001,208004 FORNIT.C/CREDITI N,,,,,
8.11.011,MATERIALI DI CONSUMO ,31/12/2021,160,N.C. DA RICEV.MERCK, ,31/12/2021, ,-224.4,97086.49000000002,208004 FORNIT.C/CREDITI N,,,,,
8.11.011,MATERIALI DI CONSUMO ,31/12/2021,160,N.C. DA RICEV.FISHE, ,31/12/2021, ,-56.2,97030.29000000002,208004 FORNIT.C/CREDITI N,,,,,
8.11.011,MATERIALI DI CONSUMO ,31/12/2021,160,N.C. DA RICEV.FISHE, ,31/12/2021, ,-360.08,96670.21000000002,208004 FORNIT.C/CREDITI N,,,,,
8.11.011,MATERIALI DI CONSUMO ,31/12/2021,150,N.B. DA RICEV. MERC, ,31/12/2021, ,877.0,97547.21000000002,503004 FATTURE DA RICEVER,,,,,
8.11.011,MATERIALI DI CONSUMO ,31/12/2021,150,FATT.WELLTECH DA RI, ,31/12/2021, ,2212.19,99759.40000000002,503004 FATTURE DA RICEVER,,,,,
8.11.011,MATERIALI DI CONSUMO ,31/12/2021,150,ACQ.AMAZON , ,31/12/2021, ,26.47,99785.87000000002, diversi a diversi,,,,,
8.11.011,MATERIALI DI CONSUMO ,31/12/2021,150,ACQ.AMAZON , ,31/12/2021, ,11.47,99797.34000000003, diversi a diversi,,,,,
8.11.011,MATERIALI DI CONSUMO ,31/12/2021,150,ACQ.AMAZON , ,31/12/2021, ,17.91,99815.25000000003, diversi a diversi,,,,,
8.11.011,MATERIALI DI CONSUMO ,31/12/2021,150,ACQ.AMAZON , ,31/12/2021, ,11.47,99826.72000000003, diversi a diversi,,,,,
8.11.011,MATERIALI DI CONSUMO ,31/12/2021,150,ACQ.AMAZON , ,31/12/2021, ,9.01,99835.73000000003, diversi a diversi,,,,,
8.11.011,MATERIALI DI CONSUMO ,31/12/2021,150,ACQ.AMAZON , ,31/12/2021, ,63.32,99899.05000000003, diversi a diversi,,,,,
8.11.013,CANONI ASSISTENZA PROCEDURE INFORMATICHE ,30/11/2021,199,ACQUISTI REVERSE CH,84883,22/11/2021,412,363.0,363.0,DANEA DANEA SOFT SRL,,,,,
8.11.013,CANONI ASSISTENZA PROCEDURE INFORMATICHE ,31/12/2021,160,LIC.FATT.ELETTR.COM, ,31/12/2021, ,-354.55,8.449999999999989,323001 RISCONTI ATTIVI,,,,,
8.12.000,LOCAZIONI ,31/03/2021,100,FATTURA DI ACQUISTO,VEAAM-2,18/03/2021,87,1200.0,1200.0,CERTS Universita degli S,,,,,
8.12.000,LOCAZIONI ,31/07/2021,100,FATTURA DI ACQUISTO,8,05/07/2021,235,2500.0,3700.0,SEREN1 SERENITAS S.R.L.,,,,,
8.12.000,LOCAZIONI ,31/08/2021,100,FATTURA DI ACQUISTO,9,03/08/2021,266,2500.0,6200.0,SEREN1 SERENITAS S.R.L.,,,,,
8.12.000,LOCAZIONI ,23/09/2021,100,FATTURA DI ACQUISTO,12,01/09/2021,282,2500.0,8700.0,SEREN1 SERENITAS S.R.L.,,,,,
8.12.000,LOCAZIONI ,31/10/2021,100,FATTURA DI ACQUISTO,13,01/10/2021,308,2500.0,11200.0,SEREN1 SERENITAS S.R.L.,,,,,
8.12.000,LOCAZIONI ,31/10/2021,199,ACQUISTI REVERSE CH,FPR70 ,07/10/2021,331,10886.01,22086.01,ICTSUD CENTRO DI COMPETEN,,,,,
8.12.000,LOCAZIONI ,31/10/2021,100,FATTURA DI ACQUISTO,VEAAM-7,26/10/2021,356,2000.0,24086.01,CERTS Universita degli S,,,,,
8.12.000,LOCAZIONI ,31/10/2021,160,MESE DICEMBRE 2020 , ,31/10/2021, ,-904.17,23181.84,846009 COSTI NON DI COMPE,,,,,
8.12.000,LOCAZIONI ,30/11/2021,100,FATTURA DI ACQUISTO,14,02/11/2021,377,2500.0,25681.84,SEREN1 SERENITAS S.R.L.,,,,,
8.12.000,LOCAZIONI ,20/12/2021,100,FATTURA DI ACQUISTO,16,01/12/2021,443,2500.0,28181.84,SEREN1 SERENITAS S.R.L.,,,,,
8.12.000,LOCAZIONI ,31/12/2021,160,LOCAZ.EX POSTE COMP, ,31/12/2021, ,-1200.0,26981.84,323001 RISCONTI ATTIVI,,,,,
8.12.000,LOCAZIONI ,31/12/2021,150,COMPET.2021 EX-CASE, ,31/12/2021, ,86101.68,113083.52,512001 RATEI PASSIVI,,,,,
8.12.000,LOCAZIONI ,31/12/2021,150,PIANO CAPPELLE COMP, ,31/12/2021, ,7440.0,120523.52,512001 RATEI PASSIVI,,,,,
8.12.000,LOCAZIONI ,31/12/2021,150,SEDE NAPOLI DICEMBR, ,31/12/2021, ,904.17,121427.69,512001 RATEI PASSIVI,,,,,
8.14.000,ALTRE UTENZE ,28/02/2021,199,ACQUISTI REVERSE CH,63902,01/02/2021,41,44.64,44.64,LINKEM LINKEM S.P.A.,,,,,
8.14.000,ALTRE UTENZE ,30/04/2021,199,ACQUISTI REVERSE CH,36173,03/04/2021,108,43.52,88.16,LINKEM LINKEM S.P.A.,,,,,
8.14.000,ALTRE UTENZE ,30/06/2021,199,ACQUISTI REVERSE CH,1212021,31/05/2021,178,39.84,128.0,LINKEM LINKEM S.P.A.,,,,,
8.14.000,ALTRE UTENZE ,31/08/2021,199,ACQUISTI REVERSE CH,23833,01/08/2021,272,39.84,167.84,LINKEM LINKEM S.P.A.,,,,,
8.14.000,ALTRE UTENZE ,31/10/2021,199,ACQUISTI REVERSE CH,40960,29/09/2021,326,39.84,207.68,LINKEM LINKEM S.P.A.,,,,,
8.14.000,ALTRE UTENZE ,20/12/2021,199,ACQUISTI REVERSE CH,67086,29/11/2021,446,49.8,257.48,LINKEM LINKEM S.P.A.,,,,,
8.14.001,TELEFONICHE ,31/01/2021,199,ACQUISTI REVERSE CH,67582,21/01/2021,12,473.44,473.44,VODAFO VODAFONE ITALIA S.,,,,,
8.14.001,TELEFONICHE ,31/03/2021,199,ACQUISTI REVERSE CH,91042,20/03/2021,91,454.34,927.78,VODAFO VODAFONE ITALIA S.,,,,,
8.14.001,TELEFONICHE ,31/05/2021,199,ACQUISTI REVERSE CH,907815,20/05/2021,163,511.31,1439.09,VODAFO VODAFONE ITALIA S.,,,,,
8.14.001,TELEFONICHE ,31/07/2021,199,ACQUISTI REVERSE CH,51125,22/07/2021,253,474.06,1913.15,VODAFO VODAFONE ITALIA S.,,,,,
8.14.001,TELEFONICHE ,30/09/2021,199,ACQUISTI REVERSE CH,88667,22/09/2021,292,458.03,2371.18,VODAFO VODAFONE ITALIA S.,,,,,
8.14.001,TELEFONICHE ,30/11/2021,199,ACQUISTI REVERSE CH,60385,20/11/2021,413,415.84,2787.02,VODAFO VODAFONE ITALIA S.,,,,,
8.14.004,SPESE POSTALI ,31/05/2021,110,ACQUISTO IVA N/DETR,76787,19/05/2021,166,6.48,6.48,POSITA POSTE ITALIANE SPA,,,,,
8.14.004,SPESE POSTALI ,12/06/2021,150,ADDEB.CARTA CRED.SP, ,12/06/2021, ,4.98,11.46,102024 BANCA DELLA CAMPAN,,,,,
8.14.004,SPESE POSTALI ,30/06/2021,199,ACQUISTI REVERSE CH,30712,19/05/2021,182,5.31,16.77,POSITA POSTE ITALIANE SPA,,,,,
8.14.004,SPESE POSTALI ,30/06/2021,1110,ACQUISTO IVA N/DETR,30711,19/05/2021,183,-6.48,10.29,POSITA POSTE ITALIANE SPA,,,,,
8.14.004,SPESE POSTALI ,30/11/2021,199,ACQUISTI REVERSE CH,35843,23/11/2021,425,3.7,13.99,POSITA POSTE ITALIANE SPA,,,,,
8.14.004,SPESE POSTALI ,13/12/2021,150,STORNO PAGAM.CARTA , ,13/12/2021, ,4.51,18.5,208001 FORNITORI C/ANTICI,,,,,
8.14.005,SPESE GENERALI ,11/02/2021,150,QUOTE ASSOC.SIE , ,11/02/2021, ,630.0,630.0, diversi a diversi,,,,,
8.14.005,SPESE GENERALI ,11/02/2021,150,QUOTE ASSOC.SIE , ,11/02/2021, ,25.0,655.0, diversi a diversi,,,,,
8.14.005,SPESE GENERALI ,28/02/2021,199,ACQUISTI REVERSE CH,47,26/02/2021,63,69.09,724.09,GBVEND GB VENDING SRLS,,,,,
8.14.005,SPESE GENERALI ,03/03/2021,150,RIMB.SPESE X TELEGR, ,03/03/2021, ,6.48,730.57,101001 CASSA CONTANTI,,,,,
8.14.005,SPESE GENERALI ,31/05/2021,199,ACQUISTI REVERSE CH,104,04/05/2021,147,76.23,806.8000000000001,GBVEND GB VENDING SRLS,,,,,
8.14.005,SPESE GENERALI ,23/06/2021,150,DIR.SEGRET.SCIA COM, ,23/06/2021, ,150.0,956.8000000000001,102024 BANCA DELLA CAMPAN,,,,,
8.14.005,SPESE GENERALI ,15/07/2021,150,ANAC PAGOPA , ,15/07/2021, ,20.0,976.8000000000001,102024 BANCA DELLA CAMPAN,,,,,
8.14.005,SPESE GENERALI ,15/07/2021,150,ANAC PAGOPA , ,15/07/2021, ,35.0,1011.8,102024 BANCA DELLA CAMPAN,,,,,
8.14.005,SPESE GENERALI ,15/07/2021,150,ANAC PAGOPA , ,15/07/2021, ,35.0,1046.8,102024 BANCA DELLA CAMPAN,,,,,
8.14.005,SPESE GENERALI ,31/07/2021,199,ACQUISTI REVERSE CH,146,06/07/2021,222,107.27,1154.07,GBVEND GB VENDING SRLS,,,,,
8.14.005,SPESE GENERALI ,14/08/2021,150,PAG.ANAC CARTA CRED, ,14/08/2021, ,20.0,1174.07,102024 BANCA DELLA CAMPAN,,,,,
8.14.005,SPESE GENERALI ,14/08/2021,150,PAG.ANAC CARTA CRED, ,14/08/2021, ,20.0,1194.07,102024 BANCA DELLA CAMPAN,,,,,
8.14.005,SPESE GENERALI ,14/08/2021,150,PAG.ANAC CARTA CRED, ,14/08/2021, ,35.0,1229.07,102024 BANCA DELLA CAMPAN,,,,,
8.14.005,SPESE GENERALI ,14/08/2021,150,PAG.ANAC CARTA CRED, ,14/08/2021, ,35.0,1264.07,102024 BANCA DELLA CAMPAN,,,,,
8.14.005,SPESE GENERALI ,25/10/2021,150,SPESE X SCIA PADULI, ,25/10/2021, ,50.0,1314.07,102024 BANCA DELLA CAMPAN,,,,,
8.14.005,SPESE GENERALI ,26/10/2021,150,SOMMEXESPLET.FUNZ.S, ,26/10/2021, ,7247.22,8561.29,102024 BANCA DELLA CAMPAN,,,,,
8.14.005,SPESE GENERALI ,26/10/2021,150,PAG.A AUT.NAZ.ANTIC, ,26/10/2021, ,2730.0,11291.29,102024 BANCA DELLA CAMPAN,,,,,
8.14.005,SPESE GENERALI ,13/11/2021,150,ISCR.IEEE CARTA CRE, ,12/11/2021, ,159.04,11450.33,102024 BANCA DELLA CAMPAN,,,,,
8.14.005,SPESE GENERALI ,30/11/2021,100,FATTURA DI ACQUISTO,115,25/11/2021,426,500.0,11950.33,ASSO23 Associazione Clus,,,,,
8.14.005,SPESE GENERALI ,17/12/2021,150,PAGAM.REG.CAMPANIA , ,17/12/2021, ,100.0,12050.33, diversi a diversi,,,,,
8.14.005,SPESE GENERALI ,20/12/2021,199,ACQUISTI REVERSE CH,234,14/12/2021,454,104.92,12155.25,GBVEND GB VENDING SRLS,,,,,
8.14.005,SPESE GENERALI ,31/12/2021,160,QUOTA ADES.ASS.CLUS, ,31/12/2021, ,-500.0,11655.25,323001 RISCONTI ATTIVI,,,,,
8.14.007,COMPETENZE PER OPERAZIONI DOGANALI ,31/03/2021,100,FATTURA DI ACQUISTO,42230,22/03/2021,100,13.5,13.5,FEDEXE FEDEX EXPRESS ITAL,,,,,
8.14.007,COMPETENZE PER OPERAZIONI DOGANALI ,30/04/2021,100,FATTURA DI ACQUISTO,2190127,12/04/2021,135,13.5,27.0,FEDEXE FEDEX EXPRESS ITAL,,,,,
8.14.007,COMPETENZE PER OPERAZIONI DOGANALI ,30/04/2021,100,FATTURA DI ACQUISTO,2190127,12/04/2021,135,2.0,29.0,FEDEXE FEDEX EXPRESS ITAL,,,,,
8.14.007,COMPETENZE PER OPERAZIONI DOGANALI ,31/10/2021,100,FATTURA DI ACQUISTO,46495,27/10/2021,371,15.0,44.0,FEDEXE FEDEX EXPRESS ITAL,,,,,
8.14.007,COMPETENZE PER OPERAZIONI DOGANALI ,31/10/2021,100,FATTURA DI ACQUISTO,46495,27/10/2021,371,2.0,46.0,FEDEXE FEDEX EXPRESS ITAL,,,,,
8.14.007,COMPETENZE PER OPERAZIONI DOGANALI ,31/10/2021,100,FATTURA DI ACQUISTO,16630,19/10/2021,374,15.0,61.0,FEDEXE FEDEX EXPRESS ITAL,,,,,
8.14.007,COMPETENZE PER OPERAZIONI DOGANALI ,31/10/2021,100,FATTURA DI ACQUISTO,16630,19/10/2021,374,2.0,63.0,FEDEXE FEDEX EXPRESS ITAL,,,,,
8.14.007,COMPETENZE PER OPERAZIONI DOGANALI ,30/11/2021,100,FATTURA DI ACQUISTO,32692,26/11/2021,420,17.0,80.0,FEDEXE FEDEX EXPRESS ITAL,,,,,
8.14.010,ACQUISTO DI ATTREZZATURE ,31/01/2021,199,ACQUISTI REVERSE CH,3,28/01/2021,18,450.0,450.0,ZIEGLE ZIEGLER EMILIO OFF,,,,,
8.14.010,ACQUISTO DI ATTREZZATURE ,28/02/2021,199,ACQUISTI REVERSE CH,89/21 ,04/02/2021,43,890.0,1340.0,NOINTE NOVA INFORMATION T,,,,,
8.14.010,ACQUISTO DI ATTREZZATURE ,28/02/2021,199,ACQUISTI REVERSE CH,89/21 ,04/02/2021,43,1010.0,2350.0,NOINTE NOVA INFORMATION T,,,,,
8.14.010,ACQUISTO DI ATTREZZATURE ,28/02/2021,199,ACQUISTI REVERSE CH,204112,22/02/2021,61,498.0,2848.0,SIGMAA SIGMA ALDRICH S.R.,,,,,
8.14.010,ACQUISTO DI ATTREZZATURE ,28/02/2021,199,ACQUISTI REVERSE CH,71/2021,26/02/2021,64,611.41,3459.41,DBELE DB ELECTRONIC INST,,,,,
8.14.010,ACQUISTO DI ATTREZZATURE ,31/03/2021,199,ACQUISTI REVERSE CH,86/2021,05/03/2021,76,579.14,4038.55,DBELE DB ELECTRONIC INST,,,,,
8.14.010,ACQUISTO DI ATTREZZATURE ,31/03/2021,100,FATTURA DI ACQUISTO,74099,23/03/2021,92,393.43,4431.98,AMAEU Amazon EU S.a r.l.,,,,,
8.14.010,ACQUISTO DI ATTREZZATURE ,31/03/2021,1100,FATTURA DI ACQUISTO,182890,23/03/2021,93,-393.45,4038.53,AMAEU Amazon EU S.a r.l.,,,,,
8.14.010,ACQUISTO DI ATTREZZATURE ,31/03/2021,199,ACQUISTI REVERSE CH,182985,24/03/2021,94,393.41,4431.94,AMAEU Amazon EU S.a r.l.,,,,,
8.14.010,ACQUISTO DI ATTREZZATURE ,06/04/2021,150,DIVANO 2 POSTI RIC., ,06/04/2021, ,177.01,4608.95, diversi a diversi,,,,,
8.14.010,ACQUISTO DI ATTREZZATURE ,30/04/2021,199,ACQUISTI REVERSE CH,036-21 ,30/03/2021,105,1883.0,6491.95,DORATE DORA TECNOLOGIE DI,,,,,
8.14.010,ACQUISTO DI ATTREZZATURE ,30/04/2021,199,ACQUISTI REVERSE CH,124,21/04/2021,124,337.98,6829.93,DBELE DB ELECTRONIC INST,,,,,
8.14.010,ACQUISTO DI ATTREZZATURE ,31/05/2021,199,ACQUISTI REVERSE CH,136,03/05/2021,148,271.49,7101.42,DBELE DB ELECTRONIC INST,,,,,
8.14.010,ACQUISTO DI ATTREZZATURE ,31/05/2021,199,ACQUISTI REVERSE CH,13 / PA,17/05/2021,157,1557.6,8659.02,TRTURO T.R. TURONI S.R.L.,,,,,
8.14.010,ACQUISTO DI ATTREZZATURE ,31/05/2021,199,ACQUISTI REVERSE CH,1219,20/05/2021,162,3946.0,12605.02,OPTOTR OPTOTRIM S.R.L.,,,,,
8.14.010,ACQUISTO DI ATTREZZATURE ,31/05/2021,199,ACQUISTI REVERSE CH,214,24/05/2021,164,292.0,12897.02,ECOSEA ECOSEARCH S.R.L.,,,,,
8.14.010,ACQUISTO DI ATTREZZATURE ,30/06/2021,199,ACQUISTI REVERSE CH,178,07/06/2021,180,298.27,13195.29,DBELE DB ELECTRONIC INST,,,,,
8.14.010,ACQUISTO DI ATTREZZATURE ,30/06/2021,199,ACQUISTI REVERSE CH,68,09/06/2021,181,442.0,13637.29,MISURE MISURE S.N.C. DI B,,,,,
8.14.010,ACQUISTO DI ATTREZZATURE ,30/06/2021,100,FATTURA DI ACQUISTO,22824,11/06/2021,185,0.0,13637.29,VODAFO VODAFONE ITALIA S.,,,,,
8.14.010,ACQUISTO DI ATTREZZATURE ,30/07/2021,199,ACQUISTI REVERSE CH,55060,30/06/2021,213,165.0,13802.29,VWR VWR INTERNATIONAL,,,,,
8.14.010,ACQUISTO DI ATTREZZATURE ,30/07/2021,199,ACQUISTI REVERSE CH,068-21 ,30/06/2021,214,998.0,14800.29,DORATE DORA TECNOLOGIE DI,,,,,
8.14.010,ACQUISTO DI ATTREZZATURE ,31/07/2021,199,ACQUISTI REVERSE CH,469/21 ,02/07/2021,217,1609.0,16409.29,NOINTE NOVA INFORMATION T,,,,,
8.14.010,ACQUISTO DI ATTREZZATURE ,31/07/2021,199,ACQUISTI REVERSE CH,38,30/06/2021,226,2320.0,18729.29,REMEDI REMEDIX S.R.L.,,,,,
8.14.010,ACQUISTO DI ATTREZZATURE ,31/07/2021,199,ACQUISTI REVERSE CH,26,20/07/2021,243,400.0,19129.29,ZIEGLE ZIEGLER EMILIO OFF,,,,,
8.14.010,ACQUISTO DI ATTREZZATURE ,30/09/2021,40104,ACQUISTO MERCI NO R,210112,15/09/2021,302,128.32,19257.61, diversi a diversi,,,,,
8.14.010,ACQUISTO DI ATTREZZATURE ,12/10/2021,150,"ADDEV.RICEV.ACQU,ON", ,12/10/2021, ,159.99,19417.6,102024 BANCA DELLA CAMPAN,,,,,
8.14.010,ACQUISTO DI ATTREZZATURE ,12/10/2021,150,ADDEB.RICEV.ACQ.ONL, ,12/10/2021, ,133.26,19550.86,102024 BANCA DELLA CAMPAN,,,,,
8.14.010,ACQUISTO DI ATTREZZATURE ,12/10/2021,150,ADDEB.RICEV.ACQ.ONL, ,12/10/2021, ,130.69,19681.55,102024 BANCA DELLA CAMPAN,,,,,
8.14.010,ACQUISTO DI ATTREZZATURE ,31/10/2021,199,ACQUISTI REVERSE CH,20543,06/10/2021,330,461.7,20143.25,GEHEAL Cytiva Europe GmbH,,,,,
8.14.010,ACQUISTO DI ATTREZZATURE ,31/10/2021,199,ACQUISTI REVERSE CH,24032,15/10/2021,336,1323.0,21466.25,SIGMAA SIGMA ALDRICH S.R.,,,,,
8.14.010,ACQUISTO DI ATTREZZATURE ,31/10/2021,110,ACQUISTO IVA N/DETR,239113,10/10/2021,333,215.39,21681.64,AMAEU Amazon EU S.a r.l.,,,,,
8.14.010,ACQUISTO DI ATTREZZATURE ,31/10/2021,1110,ACQUISTO IVA N/DETR,217106,15/10/2021,337,-215.39,21466.25,AMAEU Amazon EU S.a r.l.,,,,,
8.14.010,ACQUISTO DI ATTREZZATURE ,31/10/2021,199,ACQUISTI REVERSE CH,217195,16/10/2021,339,176.55,21642.8,AMAEU Amazon EU S.a r.l.,,,,,
8.14.010,ACQUISTO DI ATTREZZATURE ,31/10/2021,1199,ACQUISTI REVERSE CH,20633,18/10/2021,347,-461.7,21181.1,GEHEAL Cytiva Europe GmbH,,,,,
8.14.010,ACQUISTO DI ATTREZZATURE ,31/10/2021,199,ACQUISTI REVERSE CH,01014/0,26/10/2021,359,505.7,21686.8,DELTEK DELTEK SRL,,,,,
8.14.010,ACQUISTO DI ATTREZZATURE ,30/11/2021,179,ACQUISTI ART. 17 va,32477,08/10/2021,437,286.18,21972.98,JUNHON SHENZEN SHI JUNHON,,,,,
8.14.010,ACQUISTO DI ATTREZZATURE ,31/12/2021,199,ACQUISTI REVERSE CH,787/21 ,30/12/2021,471,2217.95,24190.93,NOINTE NOVA INFORMATION T,,,,,
8.14.010,ACQUISTO DI ATTREZZATURE ,31/12/2021,150,ALIMENT.DA BANCO FA, ,31/12/2021, ,196.68,24387.61,503004 FATTURE DA RICEVER,,,,,
8.14.011,ONERI PER OPERAZIONI CON L'ESTERO ,28/02/2021,106,BOLLETTA DOGANALE ,395183,19/01/2021,66,23.37,23.37,510005 SPEDIZIONIERI C/SP,,,,,
8.14.021,RIMBORSI SPESE ANTICIPATE ,04/01/2021,150,RIMB.SPESE E.NAPOLI, ,04/01/2021, ,164.31,164.31,102024 BANCA DELLA CAMPAN,,,,,
8.14.021,RIMBORSI SPESE ANTICIPATE ,04/01/2021,150,RIMB.SPESE IRACE , ,14/01/2021, ,641.04,805.3499999999999,102024 BANCA DELLA CAMPAN,,,,,
8.14.021,RIMBORSI SPESE ANTICIPATE ,28/02/2021,199,ACQUISTI REVERSE CH,4,08/02/2021,42,3360.0,4165.35,DATTIL DATTILO S.C. A R.L,,,,,
8.14.021,RIMBORSI SPESE ANTICIPATE ,03/03/2021,150,RIMB.SPESE GUARINO , ,18/01/2021, ,7.5,4172.85,101001 CASSA CONTANTI,,,,,
8.14.021,RIMBORSI SPESE ANTICIPATE ,03/03/2021,150,RIMB.SPESE CIBELLI , ,23/02/2021, ,72.7,4245.55,101001 CASSA CONTANTI,,,,,
8.14.021,RIMBORSI SPESE ANTICIPATE ,03/03/2021,150,RIMB.SPESE LUONGO , ,03/03/2021, ,103.8,4349.35,102024 BANCA DELLA CAMPAN,,,,,
8.14.021,RIMBORSI SPESE ANTICIPATE ,03/03/2021,150,RIMB.SPESE SALZA , ,03/03/2021, ,100.26,4449.610000000001,102024 BANCA DELLA CAMPAN,,,,,
8.14.021,RIMBORSI SPESE ANTICIPATE ,09/03/2021,150,RIMB.SPESE LUONGO , ,09/03/2021, ,21.4,4471.01,101001 CASSA CONTANTI,,,,,
8.14.021,RIMBORSI SPESE ANTICIPATE ,09/03/2021,150,RIMB.SPESE IRACE , ,09/03/2021, ,962.99,5434.0,102024 BANCA DELLA CAMPAN,,,,,
8.14.021,RIMBORSI SPESE ANTICIPATE ,08/04/2021,150,RIMB.SPESE CIBELLI , ,08/04/2021, ,70.16,5504.16,101001 CASSA CONTANTI,,,,,
8.14.021,RIMBORSI SPESE ANTICIPATE ,21/04/2021,150,RIMB.SPESE CIBELLI , ,21/04/2021, ,25.0,5529.16,101001 CASSA CONTANTI,,,,,
8.14.021,RIMBORSI SPESE ANTICIPATE ,27/04/2021,150,RIMB.PECORI ISCR.PE, ,27/04/2021, ,331.48,5860.639999999999,102024 BANCA DELLA CAMPAN,,,,,
8.14.021,RIMBORSI SPESE ANTICIPATE ,06/05/2021,150,RIMB.SPESE IRACE , ,06/05/2021, ,927.32,6787.959999999999,102024 BANCA DELLA CAMPAN,,,,,
8.14.021,RIMBORSI SPESE ANTICIPATE ,27/05/2021,150,RIMB.SPESE CUOMO , ,27/05/2021, ,5.77,6793.73,101001 CASSA CONTANTI,,,,,
8.14.021,RIMBORSI SPESE ANTICIPATE ,22/06/2021,150,RIMB.SPESE LUONGO , ,22/06/2021, ,99.78,6893.509999999999,102024 BANCA DELLA CAMPAN,,,,,
8.14.021,RIMBORSI SPESE ANTICIPATE ,02/07/2021,150,RIMB.SPESE SALZA , ,02/07/2021, ,56.0,6949.509999999999,101001 CASSA CONTANTI,,,,,
8.14.021,RIMBORSI SPESE ANTICIPATE ,21/07/2021,150,RIMB.SPESE IRACE , ,21/07/2021, ,1036.4,7985.91,102024 BANCA DELLA CAMPAN,,,,,
8.14.021,RIMBORSI SPESE ANTICIPATE ,21/07/2021,150,RIMB.SPESE MARRAZZO, ,21/07/2021, ,304.45,8290.36,102024 BANCA DELLA CAMPAN,,,,,
8.14.021,RIMBORSI SPESE ANTICIPATE ,02/07/2021,150,RIMB.SPESE LUONGO , ,22/07/2021, ,211.02,8501.380000000001,102024 BANCA DELLA CAMPAN,,,,,
8.14.021,RIMBORSI SPESE ANTICIPATE ,02/07/2021,150,RIMB.SPESE SALZA , ,22/07/2021, ,40.66,8542.04,101001 CASSA CONTANTI,,,,,
8.14.021,RIMBORSI SPESE ANTICIPATE ,08/09/2021,150,RIMB.SPESE CIBELLI , ,08/09/2021, ,116.0,8658.04,101001 CASSA CONTANTI,,,,,
8.14.021,RIMBORSI SPESE ANTICIPATE ,09/09/2021,150,RIMB.SPESE LUONGO , ,09/09/2021, ,176.05,8834.09,102024 BANCA DELLA CAMPAN,,,,,
8.14.021,RIMBORSI SPESE ANTICIPATE ,09/09/2021,150,RIMB.SPESE IRACE , ,09/09/2021, ,509.19,9343.28,102024 BANCA DELLA CAMPAN,,,,,
8.14.021,RIMBORSI SPESE ANTICIPATE ,11/10/2021,150,RIMB.SPESE SALZA , ,11/10/2021, ,40.25,9383.53,101001 CASSA CONTANTI,,,,,
8.14.021,RIMBORSI SPESE ANTICIPATE ,22/10/2021,150,RIMB.SPESE LUONGO , ,22/10/2021, ,194.14,9577.67,102024 BANCA DELLA CAMPAN,,,,,
8.14.021,RIMBORSI SPESE ANTICIPATE ,28/10/2021,150,RIMB.SPESE GUARINO , ,28/10/2021, ,150.0,9727.67,102024 BANCA DELLA CAMPAN,,,,,
8.14.021,RIMBORSI SPESE ANTICIPATE ,05/11/2021,150,PRESTAZ.DI SCALA , ,05/11/2021, ,82.5,9810.17, diversi a diversi,,,,,
8.14.021,RIMBORSI SPESE ANTICIPATE ,10/11/2021,150,RIMB.SPESE CILARDO , ,10/11/2021, ,173.85,9984.02, diversi a diversi,,,,,
8.14.021,RIMBORSI SPESE ANTICIPATE ,05/11/2021,150,RIMB.SPESE CIBELLI , ,15/11/2021, ,80.33,10064.35,101001 CASSA CONTANTI,,,,,
8.14.021,RIMBORSI SPESE ANTICIPATE ,16/11/2021,150,RIMB.TRASF.PAURA , ,16/11/2021, ,139.0,10203.35,102024 BANCA DELLA CAMPAN,,,,,
8.14.021,RIMBORSI SPESE ANTICIPATE ,30/11/2021,199,ACQUISTI REVERSE CH,19,25/11/2021,416,2625.0,12828.35,DATTIL DATTILO S.C. A R.L,,,,,
8.14.021,RIMBORSI SPESE ANTICIPATE ,03/12/2021,150,RIMB.SPESE FIENGA , ,03/12/2021, ,75.76,12904.11,102024 BANCA DELLA CAMPAN,,,,,
8.14.021,RIMBORSI SPESE ANTICIPATE ,10/12/2021,150,RIMB.SPESE REGISTR., ,10/12/2021, ,263.0,13167.11,102024 BANCA DELLA CAMPAN,,,,,
8.14.021,RIMBORSI SPESE ANTICIPATE ,04/12/2021,150,RIMB.SPESE ROMANO , ,14/12/2021, ,176.19,13343.3,102024 BANCA DELLA CAMPAN,,,,,
8.14.021,RIMBORSI SPESE ANTICIPATE ,04/12/2021,150,RIMB.SPESE ROMANO , ,14/12/2021, ,15.9,13359.2,102024 BANCA DELLA CAMPAN,,,,,
8.14.021,RIMBORSI SPESE ANTICIPATE ,20/12/2021,150,RIMB.SPESE BORGHESE, ,20/12/2021, ,41.35,13400.55,102024 BANCA DELLA CAMPAN,,,,,
8.14.021,RIMBORSI SPESE ANTICIPATE ,20/12/2021,150,RIMB.SPESE CIBELLI , ,20/12/2021, ,72.6,13473.15,102024 BANCA DELLA CAMPAN,,,,,
8.14.021,RIMBORSI SPESE ANTICIPATE ,22/12/2021,150,RIMB.SPESE GUARINO , ,22/12/2021, ,200.0,13673.15, diversi a diversi,,,,,
8.14.021,RIMBORSI SPESE ANTICIPATE ,22/12/2021,150,RIMB.SPESE CIBELLI , ,22/12/2021, ,16.0,13689.15,101001 CASSA CONTANTI,,,,,
8.14.024,CONTRIBUTO PER LA RICERCA ,13/09/2021,150,"ADEGUAM.FINANZ,BORS", ,13/09/2021, ,1820.5,1820.5,102024 BANCA DELLA CAMPAN,,,,,
8.15.005,DIRITTI PER TRASMISSIONE TELEMATICA Periodo dal 01/01/21 al 31/12/21 ,14/08/2021,150,PAG.ANAC CARTA CRED, ,14/08/2021, ,70.0,70.0,102024 BANCA DELLA CAMPAN,,,,,
8.16.000,COMPENSI PROFESSIONALI E DI LAVORO AUTONOMO ,31/01/2021,135,CONSULENZE CON R/AC,676/1 ,29/12/2020,1,250.0,250.0,GUSTRO GUSTAVO TROTTA,,,,,
8.16.000,COMPENSI PROFESSIONALI E DI LAVORO AUTONOMO ,31/01/2021,135,CONSULENZE CON R/AC,4,11/01/2021,28,1662.5,1912.5,PETDOM DR. DOMENICO PETRU,,,,,
8.16.000,COMPENSI PROFESSIONALI E DI LAVORO AUTONOMO ,28/02/2021,135,CONSULENZE CON R/AC,44317,17/02/2021,55,2806.0,4718.5,SILVMA STUDIO COMM.DOTT.M,,,,,
8.16.000,COMPENSI PROFESSIONALI E DI LAVORO AUTONOMO ,28/02/2021,135,CONSULENZE CON R/AC,44317,17/02/2021,55,112.24,4830.74,SILVMA STUDIO COMM.DOTT.M,,,,,
8.16.000,COMPENSI PROFESSIONALI E DI LAVORO AUTONOMO ,28/02/2021,135,CONSULENZE CON R/AC,84/1 ,16/02/2021,56,150.0,4980.74,GUSTRO GUSTAVO TROTTA,,,,,
8.16.000,COMPENSI PROFESSIONALI E DI LAVORO AUTONOMO ,31/03/2021,135,CONSULENZE CON R/AC,133/1 ,04/03/2021,75,150.0,5130.74,GUSTRO GUSTAVO TROTTA,,,,,
8.16.000,COMPENSI PROFESSIONALI E DI LAVORO AUTONOMO ,30/04/2021,135,CONSULENZE CON R/AC,1,14/01/2021,138,1250.0,6380.74,VERCHI VERDONE CHIARA,,,,,
8.16.000,COMPENSI PROFESSIONALI E DI LAVORO AUTONOMO ,30/04/2021,135,CONSULENZE CON R/AC,2,19/02/2021,139,1250.0,7630.74,VERCHI VERDONE CHIARA,,,,,
8.16.000,COMPENSI PROFESSIONALI E DI LAVORO AUTONOMO ,30/04/2021,135,CONSULENZE CON R/AC,3,18/03/2021,140,1250.0,8880.74,VERCHI VERDONE CHIARA,,,,,
8.16.000,COMPENSI PROFESSIONALI E DI LAVORO AUTONOMO ,30/04/2021,135,CONSULENZE CON R/AC,4,20/04/2021,141,1250.0,10130.74,VERCHI VERDONE CHIARA,,,,,
8.16.000,COMPENSI PROFESSIONALI E DI LAVORO AUTONOMO ,31/05/2021,135,CONSULENZE CON R/AC,23,15/05/2021,153,2392.0,12522.74,SILVMA STUDIO COMM.DOTT.M,,,,,
8.16.000,COMPENSI PROFESSIONALI E DI LAVORO AUTONOMO ,31/05/2021,135,CONSULENZE CON R/AC,23,15/05/2021,153,95.68,12618.42,SILVMA STUDIO COMM.DOTT.M,,,,,
8.16.000,COMPENSI PROFESSIONALI E DI LAVORO AUTONOMO ,30/06/2021,135,CONSULENZE CON R/AC,5,19/05/2021,210,1250.0,13868.42,VERCHI VERDONE CHIARA,,,,,
8.16.000,COMPENSI PROFESSIONALI E DI LAVORO AUTONOMO ,30/06/2021,135,CONSULENZE CON R/AC,6,21/06/2021,211,1250.0,15118.42,VERCHI VERDONE CHIARA,,,,,
8.16.000,COMPENSI PROFESSIONALI E DI LAVORO AUTONOMO ,31/07/2021,135,CONSULENZE CON R/AC,7,22/07/2021,264,1250.0,16368.42,VERCHI VERDONE CHIARA,,,,,
8.16.000,COMPENSI PROFESSIONALI E DI LAVORO AUTONOMO ,31/08/2021,135,CONSULENZE CON R/AC,111/FE ,30/08/2021,279,3000.0,19368.42,SOPRAN SOPRANO & ASSOCIAT,,,,,
8.16.000,COMPENSI PROFESSIONALI E DI LAVORO AUTONOMO ,31/08/2021,135,CONSULENZE CON R/AC,111/FE ,30/08/2021,279,120.0,19488.42,SOPRAN SOPRANO & ASSOCIAT,,,,,
8.16.000,COMPENSI PROFESSIONALI E DI LAVORO AUTONOMO ,31/08/2021,135,CONSULENZE CON R/AC,7A ,16/06/2021,280,8640.0,28128.42,CASCRI DOTT. CHRISTIAN CA,,,,,
8.16.000,COMPENSI PROFESSIONALI E DI LAVORO AUTONOMO ,23/09/2021,135,CONSULENZE CON R/AC,44-2021,20/09/2021,290,2392.0,30520.42,SILVMA STUDIO COMM.DOTT.M,,,,,
8.16.000,COMPENSI PROFESSIONALI E DI LAVORO AUTONOMO ,23/09/2021,135,CONSULENZE CON R/AC,44-2021,20/09/2021,290,95.68,30616.1,SILVMA STUDIO COMM.DOTT.M,,,,,
8.16.000,COMPENSI PROFESSIONALI E DI LAVORO AUTONOMO ,30/11/2021,135,CONSULENZE CON R/AC,61,09/11/2021,393,2116.0,32732.1,SILVMA STUDIO COMM.DOTT.M,,,,,
8.16.000,COMPENSI PROFESSIONALI E DI LAVORO AUTONOMO ,30/11/2021,135,CONSULENZE CON R/AC,61,09/11/2021,393,84.64,32816.74,SILVMA STUDIO COMM.DOTT.M,,,,,
8.16.000,COMPENSI PROFESSIONALI E DI LAVORO AUTONOMO ,30/11/2021,135,CONSULENZE CON R/AC,8,27/08/2021,427,1250.0,34066.74,VERCHI VERDONE CHIARA,,,,,
8.16.000,COMPENSI PROFESSIONALI E DI LAVORO AUTONOMO ,30/11/2021,135,CONSULENZE CON R/AC,9,20/09/2021,428,1250.0,35316.74,VERCHI VERDONE CHIARA,,,,,
8.16.000,COMPENSI PROFESSIONALI E DI LAVORO AUTONOMO ,30/11/2021,135,CONSULENZE CON R/AC,10,25/10/2021,429,1250.0,36566.74,VERCHI VERDONE CHIARA,,,,,
8.16.000,COMPENSI PROFESSIONALI E DI LAVORO AUTONOMO ,30/11/2021,135,CONSULENZE CON R/AC,11,18/11/2021,430,1250.0,37816.74,VERCHI VERDONE CHIARA,,,,,
8.16.000,COMPENSI PROFESSIONALI E DI LAVORO AUTONOMO ,20/12/2021,135,CONSULENZE CON R/AC,8,01/12/2021,442,2884.62,40701.36,DIPPAS DI PALMA PASQUALE,,,,,
8.16.000,COMPENSI PROFESSIONALI E DI LAVORO AUTONOMO ,20/12/2021,135,CONSULENZE CON R/AC,8,01/12/2021,442,115.38,40816.74,DIPPAS DI PALMA PASQUALE,,,,,
8.16.019,CONSULENZE TECNICHE ,31/01/2021,199,ACQUISTI REVERSE CH,3,07/01/2021,6,950.0,950.0,NOTGER NOTARBARTOLO & GER,,,,,
8.16.019,CONSULENZE TECNICHE ,31/01/2021,199,ACQUISTI REVERSE CH,235,27/01/2021,19,950.0,1900.0,NOTGER NOTARBARTOLO & GER,,,,,
8.16.019,CONSULENZE TECNICHE ,30/04/2021,199,ACQUISTI REVERSE CH,1153,26/04/2021,129,1315.0,3215.0,NOTGER NOTARBARTOLO & GER,,,,,
8.16.019,CONSULENZE TECNICHE ,31/05/2021,135,CONSULENZE CON R/AC,FPR1/21,27/05/2021,168,5000.0,8215.0,FRADEN FRANCESCO Denaro,,,,,
8.16.019,CONSULENZE TECNICHE ,31/07/2021,199,ACQUISTI REVERSE CH,2079,22/07/2021,247,685.0,8900.0,NOTGER NOTARBARTOLO & GER,,,,,
8.16.019,CONSULENZE TECNICHE ,31/07/2021,199,ACQUISTI REVERSE CH,56/PA21,28/07/2021,256,6200.0,15100.0,HARDSO Hard & Soft House,,,,,
8.16.019,CONSULENZE TECNICHE ,31/08/2021,199,ACQUISTI REVERSE CH,104,31/07/2021,275,6800.0,21900.0,DATABO DATABOOZ ITALIA S.,,,,,
8.16.019,CONSULENZE TECNICHE ,30/11/2021,199,ACQUISTI REVERSE CH,FPR24 ,09/11/2021,391,137000.0,158900.0,KRATOS KRATOS S.R.L.,,,,,
8.16.019,CONSULENZE TECNICHE ,30/11/2021,1199,ACQUISTI REVERSE CH,3292,17/11/2021,405,-685.0,158215.0,NOTGER NOTARBARTOLO & GER,,,,,
8.16.019,CONSULENZE TECNICHE ,30/11/2021,1199,ACQUISTI REVERSE CH,3293,17/11/2021,406,-1315.0,156900.0,NOTGER NOTARBARTOLO & GER,,,,,
8.16.019,CONSULENZE TECNICHE ,30/11/2021,1199,ACQUISTI REVERSE CH,3294,17/11/2021,407,-950.0,155950.0,NOTGER NOTARBARTOLO & GER,,,,,
8.16.019,CONSULENZE TECNICHE ,30/11/2021,1199,ACQUISTI REVERSE CH,3295,17/11/2021,408,-950.0,155000.0,NOTGER NOTARBARTOLO & GER,,,,,
8.16.019,CONSULENZE TECNICHE ,30/11/2021,199,ACQUISTI REVERSE CH,3297,17/11/2021,409,4250.0,159250.0,NOTGER NOTARBARTOLO & GER,,,,,
8.16.019,CONSULENZE TECNICHE ,20/12/2021,199,ACQUISTI REVERSE CH,FPR26 ,09/12/2021,448,30000.0,189250.0,KRATOS KRATOS S.R.L.,,,,,
8.16.019,CONSULENZE TECNICHE ,20/12/2021,1199,ACQUISTI REVERSE CH,FPR27 ,09/12/2021,449,-30000.0,159250.0,KRATOS KRATOS S.R.L.,,,,,
8.16.019,CONSULENZE TECNICHE ,31/12/2021,199,ACQUISTI REVERSE CH,3667,23/12/2021,466,200.0,159450.0,NOTGER NOTARBARTOLO & GER,,,,,
8.16.019,CONSULENZE TECNICHE ,31/12/2021,199,ACQUISTI REVERSE CH,3668,23/12/2021,467,420.0,159870.0,NOTGER NOTARBARTOLO & GER,,,,,
8.17.000,VIAGGI E TRASFERTE ,09/02/2021,150,RIMB.TRASF.ROMANO , ,09/02/2021, ,185.09,185.09,102024 BANCA DELLA CAMPAN,,,,,
8.17.000,VIAGGI E TRASFERTE ,09/03/2021,150,RIMB.TRASF.CUTOLO , ,09/03/2021, ,124.0,309.09,102024 BANCA DELLA CAMPAN,,,,,
8.17.000,VIAGGI E TRASFERTE ,20/04/2021,150,RIMB.TRASF.GUARINO , ,20/04/2021, ,12.0,321.09,101001 CASSA CONTANTI,,,,,
8.17.000,VIAGGI E TRASFERTE ,06/05/2021,150,RIMB.SPESE IRACE , ,06/05/2021, ,80.72,401.8100000000001,102024 BANCA DELLA CAMPAN,,,,,
8.17.000,VIAGGI E TRASFERTE ,27/05/2021,150,RIMB.FORMAZ.BORGHES, ,27/05/2021, ,5189.35,5591.160000000001, diversi a diversi,,,,,
8.17.000,VIAGGI E TRASFERTE ,01/06/2021,150,RIMB.TRASF.GUARINO , ,01/06/2021, ,97.06,5688.220000000001,102024 BANCA DELLA CAMPAN,,,,,
8.17.000,VIAGGI E TRASFERTE ,22/06/2021,150,RIMB.TRASF.ROMANO , ,22/06/2021, ,63.5,5751.720000000001,102024 BANCA DELLA CAMPAN,,,,,
8.17.000,VIAGGI E TRASFERTE ,22/06/2021,150,"RIMB.TRASF,MICCO ", ,22/06/2021, ,383.91,6135.630000000001,102024 BANCA DELLA CAMPAN,,,,,
8.17.000,VIAGGI E TRASFERTE ,22/06/2021,150,RIMB.TRASF.CUSANO , ,22/06/2021, ,307.0,6442.630000000001,102024 BANCA DELLA CAMPAN,,,,,
8.17.000,VIAGGI E TRASFERTE ,22/06/2021,150,RIMB.TRASF.GUARINO , ,22/06/2021, ,138.75,6581.380000000001,102024 BANCA DELLA CAMPAN,,,,,
8.17.000,VIAGGI E TRASFERTE ,28/06/2021,150,RIMB.TRASF.GUARINO , ,28/06/2021, ,23.44,6604.820000000001,101001 CASSA CONTANTI,,,,,
8.17.000,VIAGGI E TRASFERTE ,21/07/2021,150,RIMB.SPESE IRACE , ,21/07/2021, ,1227.15,7831.970000000001,102024 BANCA DELLA CAMPAN,,,,,
8.17.000,VIAGGI E TRASFERTE ,31/07/2021,104,ACQUISTO MERCI NO R,44,30/06/2021,225,6897.0,14728.97,TRATIM TRAVELTIME DI MAGA,,,,,
8.17.000,VIAGGI E TRASFERTE ,08/09/2021,150,RIMB.TRASF.GUARINO , ,08/09/2021, ,5.0,14733.97,101001 CASSA CONTANTI,,,,,
8.17.000,VIAGGI E TRASFERTE ,09/09/2021,150,RIMB.SPESE LUONGO , ,09/09/2021, ,40.9,14774.87,102024 BANCA DELLA CAMPAN,,,,,
8.17.000,VIAGGI E TRASFERTE ,13/09/2021,150,RIMB.TRASF.ESPOSITO, ,13/09/2021, ,144.47,14919.34,102024 BANCA DELLA CAMPAN,,,,,
8.17.000,VIAGGI E TRASFERTE ,15/09/2021,150,RIMB.TRASF.GUARINO , ,15/09/2021, ,8.0,14927.34,101001 CASSA CONTANTI,,,,,
8.17.000,VIAGGI E TRASFERTE ,22/09/2021,150,RIMB.TRASF.IRACE , ,22/09/2021, ,1286.03,16213.37,102024 BANCA DELLA CAMPAN,,,,,
8.17.000,VIAGGI E TRASFERTE ,08/10/2021,150,S/FATT.+ EC.N.5 , ,08/10/2021, ,268.9,16482.27,102024 BANCA DELLA CAMPAN,,,,,
8.17.000,VIAGGI E TRASFERTE ,20/10/2021,150,RIMB.TRASF.GUARINO , ,20/10/2021, ,6.0,16488.27,101001 CASSA CONTANTI,,,,,
8.17.000,VIAGGI E TRASFERTE ,31/10/2021,199,ACQUISTI REVERSE CH,67/2021,30/09/2021,313,10.0,16498.27,WORLDT WORLD TRAVEL BOUTI,,,,,
8.17.000,VIAGGI E TRASFERTE ,31/10/2021,100,FATTURA DI ACQUISTO,72/2021,05/10/2021,319,230.0,16728.27,WORLDT WORLD TRAVEL BOUTI,,,,,
8.17.000,VIAGGI E TRASFERTE ,31/10/2021,100,FATTURA DI ACQUISTO,68/2021,04/10/2021,320,230.0,16958.27,WORLDT WORLD TRAVEL BOUTI,,,,,
8.17.000,VIAGGI E TRASFERTE ,31/10/2021,1199,ACQUISTI REVERSE CH,69/2021,05/10/2021,321,-10.0,16948.27,WORLDT WORLD TRAVEL BOUTI,,,,,
8.17.000,VIAGGI E TRASFERTE ,31/10/2021,1100,FATTURA DI ACQUISTO,70/2021,05/10/2021,322,-230.0,16718.27,WORLDT WORLD TRAVEL BOUTI,,,,,
8.17.000,VIAGGI E TRASFERTE ,31/10/2021,199,ACQUISTI REVERSE CH,71/2021,05/10/2021,323,10.0,16728.27,WORLDT WORLD TRAVEL BOUTI,,,,,
8.17.000,VIAGGI E TRASFERTE ,31/10/2021,100,FATTURA DI ACQUISTO,242,12/10/2021,352,557.0,17285.27,TRATIM TRAVELTIME DI MAGA,,,,,
8.17.000,VIAGGI E TRASFERTE ,04/11/2021,150,RIMB.TRASF.MARESCA , ,04/11/2021, ,759.53,18044.8,102024 BANCA DELLA CAMPAN,,,,,
8.17.000,VIAGGI E TRASFERTE ,08/11/2021,150,RIMB.TRASF.GUARINO , ,08/11/2021, ,21.0,18065.8,101001 CASSA CONTANTI,,,,,
8.17.000,VIAGGI E TRASFERTE ,16/11/2021,150,RIMB.TRASF.PAURA , ,16/11/2021, ,156.34,18222.14,102024 BANCA DELLA CAMPAN,,,,,
8.17.000,VIAGGI E TRASFERTE ,25/11/2021,150,RIMB.ISCR.ECSCRM BO, ,25/11/2021, ,610.29,18832.43,102024 BANCA DELLA CAMPAN,,,,,
8.17.000,VIAGGI E TRASFERTE ,25/11/2021,150,RIMB.TRASF.CUTOLO , ,25/11/2021, ,317.0,19149.43,102024 BANCA DELLA CAMPAN,,,,,
8.17.000,VIAGGI E TRASFERTE ,25/11/2021,150,RIMB.TRAS.IRACE , ,25/11/2021, ,398.0,19547.43,102024 BANCA DELLA CAMPAN,,,,,
8.17.000,VIAGGI E TRASFERTE ,25/11/2021,150,RIMB.TRASF.IRACE , ,25/11/2021, ,1567.92,21115.35,102024 BANCA DELLA CAMPAN,,,,,
8.17.000,VIAGGI E TRASFERTE ,30/11/2021,150,RIMB.TRASF.CUTOLO , ,30/11/2021, ,1318.75,22434.1,102024 BANCA DELLA CAMPAN,,,,,
8.17.000,VIAGGI E TRASFERTE ,30/11/2021,150,RIMB.TRASF.PAURA , ,30/11/2021, ,54.66,22488.76,102024 BANCA DELLA CAMPAN,,,,,
8.17.000,VIAGGI E TRASFERTE ,04/12/2021,150,RIMB.TRASF.ROMANO , ,14/12/2021, ,49.8,22538.56,102024 BANCA DELLA CAMPAN,,,,,
8.17.000,VIAGGI E TRASFERTE ,17/12/2021,150,RIMB.TRASF.GUARINO , ,17/12/2021, ,19.0,22557.56,101001 CASSA CONTANTI,,,,,
8.17.000,VIAGGI E TRASFERTE ,20/12/2021,150,RIMB.TRASF.IRACE , ,20/12/2021, ,1183.33,23740.89,102024 BANCA DELLA CAMPAN,,,,,
8.17.000,VIAGGI E TRASFERTE ,20/12/2021,150,RIMB.TRASF.IRACE , ,20/12/2021, ,1748.76,25489.65,102024 BANCA DELLA CAMPAN,,,,,
8.17.000,VIAGGI E TRASFERTE ,20/12/2021,150,RIMB.TRASF.IRACE , ,20/12/2021, ,761.25,26250.9,102024 BANCA DELLA CAMPAN,,,,,
8.17.000,VIAGGI E TRASFERTE ,23/12/2021,150,RIMB.TRASF.MAZZEO , ,23/12/2021, ,93.34,26344.24, diversi a diversi,,,,,
8.17.000,VIAGGI E TRASFERTE ,31/12/2021,150,RIMB.TRASF.MICCO , ,31/12/2021, ,330.23,26674.47,102024 BANCA DELLA CAMPAN,,,,,
8.17.000,VIAGGI E TRASFERTE ,31/12/2021,150,RIMB.TRASF.CUSANO , ,31/12/2021, ,117.5,26791.97,102024 BANCA DELLA CAMPAN,,,,,
8.17.000,VIAGGI E TRASFERTE ,31/12/2021,150,RIMB.TRASF.MICCO , ,31/12/2021, ,45.0,26836.97,102024 BANCA DELLA CAMPAN,,,,,
8.17.006,COMPENSI PER CORSI DI AGGIORNAMENTO ,23/09/2021,199,ACQUISTI REVERSE CH,326,10/09/2021,286,440.0,440.0,SAFET2 SAFETY-NATURE S.A.,,,,,
8.18.000,ASSICURAZIONI ,02/01/2021,150,GIROCONTO , ,02/01/2021, ,117702.11,117702.11,323001 RISCONTI ATTIVI,,,,,
8.18.000,ASSICURAZIONI ,18/02/2021,150,FIDEIUSSIONE PROG.M, ,18/02/2021, ,12793.24,130495.35,102024 BANCA DELLA CAMPAN,,,,,
8.18.000,ASSICURAZIONI ,01/06/2021,150,CAUZIONE X ANTICIP., ,11/06/2021, ,4272.5,134767.85,102024 BANCA DELLA CAMPAN,,,,,
8.18.000,ASSICURAZIONI ,26/10/2021,150,S/FATTURE+PROROGA P, ,26/10/2021, ,45120.0,179887.85,102024 BANCA DELLA CAMPAN,,,,,
8.18.000,ASSICURAZIONI ,26/10/2021,150,CAUZ.PROG.C-MOBILIT, ,26/10/2021, ,6972.1,186859.95,102024 BANCA DELLA CAMPAN,,,,,
8.18.000,ASSICURAZIONI ,26/10/2021,150,"CAUZ,PROG.P-MOBILIT", ,26/10/2021, ,5912.5,192772.45,102024 BANCA DELLA CAMPAN,,,,,
8.18.000,ASSICURAZIONI ,26/10/2021,150,CAUZ.PROG.F-MOBILIT, ,26/10/2021, ,5699.76,198472.21,102024 BANCA DELLA CAMPAN,,,,,
8.18.000,ASSICURAZIONI ,25/11/2021,150,INTEGRAZ.CAUZIONI , ,25/11/2021, ,337.5,198809.71,102024 BANCA DELLA CAMPAN,,,,,
8.18.000,ASSICURAZIONI ,31/12/2021,160,CAUZ.PROG.C-MOBIL. , ,31/12/2021, ,-5207.86,193601.85, diversi a diversi,,,,,
8.18.000,ASSICURAZIONI ,31/12/2021,160,CAUZ.PROG.P-MOBIL. , ,31/12/2021, ,-5020.47,188581.38, diversi a diversi,,,,,
8.18.000,ASSICURAZIONI ,31/12/2021,160,CAUZ.PROG.F-MOBIL. , ,31/12/2021, ,-6141.18,182440.2, diversi a diversi,,,,,
8.18.000,ASSICURAZIONI ,31/12/2021,160,RINNOVO POLIZZE COM, ,31/12/2021, ,-37579.4,144860.8,323001 RISCONTI ATTIVI,,,,,
8.18.000,ASSICURAZIONI ,31/12/2021,160,INTEGR.CAUZ.COMPET., ,31/12/2021, ,-297.28,144563.52,323001 RISCONTI ATTIVI,,,,,
8.18.000,ASSICURAZIONI ,31/12/2021,160,FIDEJUSSIONI COMP.A, ,31/12/2021, ,-5276.67,139286.85, diversi a diversi,,,,,
8.18.000,ASSICURAZIONI ,31/12/2021,160,FIDEJUSSIONI COMP.A, ,31/12/2021, ,-19404.84,119882.01, diversi a diversi,,,,,
8.18.000,ASSICURAZIONI ,31/12/2021,160,FIDEJUSSIONI COMP.A, ,31/12/2021, ,-18016.44,101865.57, diversi a diversi,,,,,
8.18.000,ASSICURAZIONI ,31/12/2021,160,FIDEJUSSIONI COMP.A, ,31/12/2021, ,-669.6,101195.97, diversi a diversi,,,,,
8.18.000,ASSICURAZIONI ,31/12/2021,160,FIDEJUSSIONI COMP.A, ,31/12/2021, ,-3333.63,97862.34000000003, diversi a diversi,,,,,
8.18.000,ASSICURAZIONI ,31/12/2021,160,FIDEJUSSIONI COMP.A, ,31/12/2021, ,-1169.85,96692.49000000002, diversi a diversi,,,,,
8.18.000,ASSICURAZIONI ,31/12/2021,160,FIDEJUSS.PROG.MAIA , ,31/12/2021, ,-9066.26,87626.23000000003,323001 RISCONTI ATTIVI,,,,,
8.18.000,ASSICURAZIONI ,31/12/2021,150,"SVINC/FIDEJ,COMPET.", ,31/12/2021, ,1934.0,89560.23000000003,512001 RATEI PASSIVI,,,,,
8.19.000,ELABORAZIONE DATI ,30/04/2021,199,ACQUISTI REVERSE CH,33,09/04/2021,114,1800.0,1800.0,START START-UP IMPRESA S,,,,,
8.19.000,ELABORAZIONE DATI ,31/07/2021,199,ACQUISTI REVERSE CH,79,13/07/2021,228,1800.0,3600.0,START START-UP IMPRESA S,,,,,
8.19.000,ELABORAZIONE DATI ,30/11/2021,199,ACQUISTI REVERSE CH,112,09/11/2021,392,1800.0,5400.0,START START-UP IMPRESA S,,,,,
8.20.002,STAMPA ED INSERZIONI ,12/02/2021,150,SPESE X PUBBLICAZ.A, ,12/02/2021, ,2867.7,2867.7,102024 BANCA DELLA CAMPAN,,,,,
8.20.007,ACQUISTI PER PROMOZIONI ,31/12/2021,199,ACQUISTI REVERSE CH,FPR18 ,23/12/2021,464,344.26,344.26,MATTSR MATTIA S.R.L.,,,,,
8.20.010,PARTECIPAZ.A CONVEGNI E CORSI ,12/02/2021,150,PARTECIPAZ.CONFER.B, ,12/02/2021, ,147.28,147.28,102024 BANCA DELLA CAMPAN,,,,,
8.20.010,PARTECIPAZ.A CONVEGNI E CORSI ,09/03/2021,150,RIMB.CASOLA CONFER., ,09/03/2021, ,315.0,462.28,102024 BANCA DELLA CAMPAN,,,,,
8.20.010,PARTECIPAZ.A CONVEGNI E CORSI ,27/04/2021,150,RIMB.ESPOSITO ISCR., ,27/04/2021, ,119.24,581.52,102024 BANCA DELLA CAMPAN,,,,,
8.20.010,PARTECIPAZ.A CONVEGNI E CORSI ,22/06/2021,150,RIMB.GRANATA ISCR.I, ,22/06/2021, ,445.0,1026.52,102024 BANCA DELLA CAMPAN,,,,,
8.20.010,PARTECIPAZ.A CONVEGNI E CORSI ,21/07/2021,150,RIMB.ISCR.CANTIELLO, ,21/07/2021, ,150.0,1176.52,102024 BANCA DELLA CAMPAN,,,,,
8.20.010,PARTECIPAZ.A CONVEGNI E CORSI ,21/07/2021,150,RIMB.SPESE MARRAZZO, ,21/07/2021, ,33.41,1209.93,102024 BANCA DELLA CAMPAN,,,,,
8.20.010,PARTECIPAZ.A CONVEGNI E CORSI ,09/09/2021,150,RIMB.AVERSANO ISCR., ,09/09/2021, ,450.0,1659.93,102024 BANCA DELLA CAMPAN,,,,,
8.20.010,PARTECIPAZ.A CONVEGNI E CORSI ,14/10/2021,150,RIMB.ISCRIZ.IEEE PE, ,14/10/2021, ,141.2,1801.13,102024 BANCA DELLA CAMPAN,,,,,
8.20.010,PARTECIPAZ.A CONVEGNI E CORSI ,04/11/2021,150,"RIMB.ISCR,ISPS MARE", ,04/11/2021, ,240.0,2041.13,102024 BANCA DELLA CAMPAN,,,,,
8.20.010,PARTECIPAZ.A CONVEGNI E CORSI ,25/11/2021,150,RIMB.ISCR.ECSCRM BO, ,25/11/2021, ,550.0,2591.13,102024 BANCA DELLA CAMPAN,,,,,
8.20.010,PARTECIPAZ.A CONVEGNI E CORSI ,25/11/2021,150,RIMB.ISCR.IEEE IRAC, ,25/11/2021, ,148.05,2739.18,102024 BANCA DELLA CAMPAN,,,,,
8.20.010,PARTECIPAZ.A CONVEGNI E CORSI ,25/11/2021,150,RIMB.ISCR.ECSCRM IR, ,25/11/2021, ,750.0,3489.18,102024 BANCA DELLA CAMPAN,,,,,
8.20.010,PARTECIPAZ.A CONVEGNI E CORSI ,04/12/2021,150,RIMB.RSCR.IEEE ROMA, ,14/12/2021, ,142.87,3632.05,102024 BANCA DELLA CAMPAN,,,,,
8.20.010,PARTECIPAZ.A CONVEGNI E CORSI ,31/12/2021,150,ISCRIZ.CILARDO DITI, ,31/12/2021, ,50.0,3682.05,503004 FATTURE DA RICEVER,,,,,
8.21.000,CANCELLERIA E STAMPATI ,31/03/2021,199,ACQUISTI REVERSE CH,222,08/03/2021,79,45.0,45.0,DELLIC GRAFICHE IUORIO S.,,,,,
8.21.000,CANCELLERIA E STAMPATI ,31/07/2021,199,ACQUISTI REVERSE CH,84,30/07/2021,257,600.0,645.0,PAONE LEGATORIA E SERIGR,,,,,
8.21.000,CANCELLERIA E STAMPATI ,30/09/2021,199,ACQUISTI REVERSE CH,1073,22/09/2021,294,15.0,660.0,DELLIC GRAFICHE IUORIO S.,,,,,
8.21.000,CANCELLERIA E STAMPATI ,31/10/2021,199,ACQUISTI REVERSE CH,26/SP ,30/09/2021,310,56.67,716.67,SIDSPA SIDERSAN SPA,,,,,
8.21.005,BOLLI/VAL.BOLLATI/CC.GG. ,31/03/2021,111,BENI STRUMENTALI ,2,18/03/2021,104,2.0,2.0,MICCAN IMPR.ED.ARTIG. MIC,,,,,
8.21.005,BOLLI/VAL.BOLLATI/CC.GG. ,15/06/2021,150,ACQ.VAL.BOLLATI , ,15/06/2021, ,224.0,226.0,101001 CASSA CONTANTI,,,,,
8.21.005,BOLLI/VAL.BOLLATI/CC.GG. ,30/06/2021,135,CONSULENZE CON R/AC,36,09/06/2021,201,2.0,228.0,BASANT ING.ANTONIO BASILE,,,,,
8.21.005,BOLLI/VAL.BOLLATI/CC.GG. ,31/07/2021,100,FATTURA DI ACQUISTO,8,05/07/2021,235,2.0,230.0,SEREN1 SERENITAS S.R.L.,,,,,
8.21.005,BOLLI/VAL.BOLLATI/CC.GG. ,31/07/2021,199,ACQUISTI REVERSE CH,627/03 ,09/07/2021,229,16.0,246.0,LGSOLU L & G SOLUTION SRL,,,,,
8.21.005,BOLLI/VAL.BOLLATI/CC.GG. ,31/07/2021,199,ACQUISTI REVERSE CH,632/03 ,09/07/2021,230,16.0,262.0,LGSOLU L & G SOLUTION SRL,,,,,
8.21.005,BOLLI/VAL.BOLLATI/CC.GG. ,31/07/2021,199,ACQUISTI REVERSE CH,634/03 ,09/07/2021,231,16.0,278.0,LGSOLU L & G SOLUTION SRL,,,,,
8.21.005,BOLLI/VAL.BOLLATI/CC.GG. ,31/07/2021,199,ACQUISTI REVERSE CH,628/03 ,09/07/2021,232,16.0,294.0,LGSOLU L & G SOLUTION SRL,,,,,
8.21.005,BOLLI/VAL.BOLLATI/CC.GG. ,31/07/2021,199,ACQUISTI REVERSE CH,630/03 ,09/07/2021,233,16.0,310.0,LGSOLU L & G SOLUTION SRL,,,,,
8.21.005,BOLLI/VAL.BOLLATI/CC.GG. ,31/07/2021,199,ACQUISTI REVERSE CH,629/03 ,09/07/2021,234,16.0,326.0,LGSOLU L & G SOLUTION SRL,,,,,
8.21.005,BOLLI/VAL.BOLLATI/CC.GG. ,31/07/2021,199,ACQUISTI REVERSE CH,631/03 ,09/07/2021,237,16.0,342.0,LGSOLU L & G SOLUTION SRL,,,,,
8.21.005,BOLLI/VAL.BOLLATI/CC.GG. ,31/07/2021,199,ACQUISTI REVERSE CH,633/03 ,09/07/2021,238,16.0,358.0,LGSOLU L & G SOLUTION SRL,,,,,
8.21.005,BOLLI/VAL.BOLLATI/CC.GG. ,31/07/2021,199,ACQUISTI REVERSE CH,741/03 ,27/07/2021,254,16.0,374.0,LGSOLU L & G SOLUTION SRL,,,,,
8.21.005,BOLLI/VAL.BOLLATI/CC.GG. ,31/08/2021,100,FATTURA DI ACQUISTO,9,03/08/2021,266,2.0,376.0,SEREN1 SERENITAS S.R.L.,,,,,
8.21.005,BOLLI/VAL.BOLLATI/CC.GG. ,23/09/2021,100,FATTURA DI ACQUISTO,12,01/09/2021,282,2.0,378.0,SEREN1 SERENITAS S.R.L.,,,,,
8.21.005,BOLLI/VAL.BOLLATI/CC.GG. ,31/10/2021,100,FATTURA DI ACQUISTO,13,01/10/2021,308,2.0,380.0,SEREN1 SERENITAS S.R.L.,,,,,
8.21.005,BOLLI/VAL.BOLLATI/CC.GG. ,31/10/2021,199,ACQUISTI REVERSE CH,932/03 ,30/09/2021,316,16.0,396.0,LGSOLU L & G SOLUTION SRL,,,,,
8.21.005,BOLLI/VAL.BOLLATI/CC.GG. ,31/10/2021,199,ACQUISTI REVERSE CH,935/03 ,30/09/2021,315,16.0,412.0,LGSOLU L & G SOLUTION SRL,,,,,
8.21.005,BOLLI/VAL.BOLLATI/CC.GG. ,31/10/2021,199,ACQUISTI REVERSE CH,921/03 ,30/09/2021,305,16.0,428.0,LGSOLU L & G SOLUTION SRL,,,,,
8.21.005,BOLLI/VAL.BOLLATI/CC.GG. ,31/10/2021,199,ACQUISTI REVERSE CH,920/03 ,30/09/2021,306,16.0,444.0,LGSOLU L & G SOLUTION SRL,,,,,
8.21.005,BOLLI/VAL.BOLLATI/CC.GG. ,31/10/2021,199,ACQUISTI REVERSE CH,922/03 ,30/09/2021,309,16.0,460.0,LGSOLU L & G SOLUTION SRL,,,,,
8.21.005,BOLLI/VAL.BOLLATI/CC.GG. ,31/10/2021,199,ACQUISTI REVERSE CH,919/03 ,30/09/2021,307,16.0,476.0,LGSOLU L & G SOLUTION SRL,,,,,
8.21.005,BOLLI/VAL.BOLLATI/CC.GG. ,31/10/2021,199,ACQUISTI REVERSE CH,936/03 ,30/09/2021,314,16.0,492.0,LGSOLU L & G SOLUTION SRL,,,,,
8.21.005,BOLLI/VAL.BOLLATI/CC.GG. ,31/10/2021,199,ACQUISTI REVERSE CH,933/03 ,30/09/2021,317,16.0,508.0,LGSOLU L & G SOLUTION SRL,,,,,
8.21.005,BOLLI/VAL.BOLLATI/CC.GG. ,08/11/2021,150,ACQ.VAL.BOLLATI , ,18/11/2021, ,10.0,518.0,101001 CASSA CONTANTI,,,,,
8.21.005,BOLLI/VAL.BOLLATI/CC.GG. ,30/11/2021,100,FATTURA DI ACQUISTO,14,02/11/2021,377,2.0,520.0,SEREN1 SERENITAS S.R.L.,,,,,
8.21.005,BOLLI/VAL.BOLLATI/CC.GG. ,15/12/2021,150,"ACQ,VALORI BOLLATI ", ,15/12/2021, ,32.0,552.0,101001 CASSA CONTANTI,,,,,
8.21.005,BOLLI/VAL.BOLLATI/CC.GG. ,20/12/2021,100,FATTURA DI ACQUISTO,16,01/12/2021,443,2.0,554.0,SEREN1 SERENITAS S.R.L.,,,,,
8.21.005,BOLLI/VAL.BOLLATI/CC.GG. ,20/12/2021,199,ACQUISTI REVERSE CH,1166/03,14/12/2021,457,16.0,570.0,LGSOLU L & G SOLUTION SRL,,,,,
8.21.005,BOLLI/VAL.BOLLATI/CC.GG. ,31/12/2021,150,FATT.DA RIC.L&G SOL, ,31/12/2021, ,16.0,586.0,503004 FATTURE DA RICEVER,,,,,
8.21.006,"ABBONAMENTI, LIBRI, RIVISTE ECC. ",30/04/2021,104,ACQUISTO MERCI NO R,3216705,20/04/2021,122,26.6,26.6,AMAEU Amazon EU S.a r.l.,,,,,
8.22.003,AMMORTAMENTO ORD. IMPIANTI TECNICI SPECIFICI ,31/12/2021,150,QUOTA AMM.TO 2021 , ,31/12/2021, ,8575.0,8575.0, diversi a diversi,,,,,
8.22.005,AMMORTAMENTO ORD. ATTREZZATURA ,31/12/2021,150,QUOTA AMM.TO 2021 , ,31/12/2021, ,10976.0,10976.0, diversi a diversi,,,,,
8.22.009,AMMORTAMENTO ORD. MACCHINE D'UFFICIO ELETTRONICHE ,31/12/2021,150,QUOTA AMM.TO 2021 , ,31/12/2021, ,10524.86,10524.86, diversi a diversi,,,,,
8.22.010,AMMORTAMENTO ORD. MOBILI ED ARREDI ,31/12/2021,150,QUOTA AMM.TO 2021 , ,31/12/2021, ,2269.65,2269.65, diversi a diversi,,,,,
8.22.013,AMMORTAMENTO ORD. IMPIANTI GENERICI ,31/12/2021,150,QUOTA AMM.TO 2021 , ,31/12/2021, ,1792.75,1792.75, diversi a diversi,,,,,
8.22.015,AMMORTAMENTO ORD. OPERE MURARIE ,31/12/2021,150,QUOTA AMM.TO 2021 , ,31/12/2021, ,253.5,253.5, diversi a diversi,,,,,
8.26.004,"AMMORTAMENTO CONCESSIONI BREVETTI, MARCHI, ECC. ",31/12/2021,150,QUOTA AMM.TO 2021 , ,31/12/2021, ,5691.98,5691.98, diversi a diversi,,,,,
8.33.000,ONERI FINANZIARI ,19/03/2021,150,EROGAZ.MUTUO N.4404, ,17/03/2021, ,5000.0,5000.0,601003 MUTUI CHIROGRAFARI,,,,,
8.33.000,ONERI FINANZIARI ,31/12/2021,160,SPESE ISTRUTTORIA M, ,31/12/2021, ,-4017.12,982.8800000000001,323001 RISCONTI ATTIVI,,,,,
8.33.006,INTERESSI PASSIVI SU MUTUI ,17/04/2021,150,RATA INTERESSI MUTU, ,17/04/2021, ,1559.54,1559.54,102024 BANCA DELLA CAMPAN,,,,,
8.33.006,INTERESSI PASSIVI SU MUTUI ,17/05/2021,150,ADDEB.RATA INTERESS, ,17/05/2021, ,1559.54,3119.08,102024 BANCA DELLA CAMPAN,,,,,
8.33.006,INTERESSI PASSIVI SU MUTUI ,17/06/2021,150,ADDEB.RATA INTERESS, ,17/06/2021, ,1559.54,4678.62,102024 BANCA DELLA CAMPAN,,,,,
8.33.006,INTERESSI PASSIVI SU MUTUI ,16/07/2021,150,ADDEB.RATA MUTUO , ,16/07/2021, ,1559.54,6238.16,102024 BANCA DELLA CAMPAN,,,,,
8.33.006,INTERESSI PASSIVI SU MUTUI ,17/08/2021,150,ADDEB.RATA MUTUO , ,17/08/2021, ,1559.54,7797.7,102024 BANCA DELLA CAMPAN,,,,,
8.33.006,INTERESSI PASSIVI SU MUTUI ,17/09/2021,150,ADDEB.RATA MUTUO , ,17/09/2021, ,1559.54,9357.24,102024 BANCA DELLA CAMPAN,,,,,
8.33.006,INTERESSI PASSIVI SU MUTUI ,17/10/2021,150,ADDEB.RATA FINANZ. , ,17/10/2021, ,1559.54,10916.78,102024 BANCA DELLA CAMPAN,,,,,
8.33.006,INTERESSI PASSIVI SU MUTUI ,17/11/2021,150,ADDEB.RATA MUTUO , ,17/11/2021, ,1559.54,12476.32,102024 BANCA DELLA CAMPAN,,,,,
8.33.006,INTERESSI PASSIVI SU MUTUI ,17/12/2021,150,ADDEB.RATA MUTUO , ,17/12/2021, ,1559.54,14035.86,102024 BANCA DELLA CAMPAN,,,,,
8.33.011,ONERI E COMMISSIONI BANCARIE ,04/01/2021,150,DARE , ,04/01/2021, ,0.83,0.83,102024 BANCA DELLA CAMPAN,,,,,
8.33.011,ONERI E COMMISSIONI BANCARIE ,08/01/2021,150,C/RETRIBUZ.BONIFICO, ,08/01/2021, ,0.83,1.66, diversi a diversi,,,,,
8.33.011,ONERI E COMMISSIONI BANCARIE ,11/01/2021,150,DARE , ,11/01/2021, ,4.15,5.81,102024 BANCA DELLA CAMPAN,,,,,
8.33.011,ONERI E COMMISSIONI BANCARIE ,13/01/2021,150,DARE , ,13/01/2021, ,52.15,57.96, diversi a diversi,,,,,
8.33.011,ONERI E COMMISSIONI BANCARIE ,14/01/2021,150,DARE , ,14/01/2021, ,3.32,61.28,102024 BANCA DELLA CAMPAN,,,,,
8.33.011,ONERI E COMMISSIONI BANCARIE ,14/01/2021,150,S/FATT.ADDEB.CARTA , ,14/01/2021, ,0.85,62.13,102024 BANCA DELLA CAMPAN,,,,,
8.33.011,ONERI E COMMISSIONI BANCARIE ,18/01/2021,150,DARE , ,18/01/2021, ,0.83,62.96,102024 BANCA DELLA CAMPAN,,,,,
8.33.011,ONERI E COMMISSIONI BANCARIE ,20/01/2021,150,S/FATT.BONIFICO , ,20/01/2021, ,0.83,63.79, diversi a diversi,,,,,
8.33.011,ONERI E COMMISSIONI BANCARIE ,21/01/2021,150,BONIFICO S/FATT. , ,21/01/2021, ,0.83,64.62, diversi a diversi,,,,,
8.33.011,ONERI E COMMISSIONI BANCARIE ,22/01/2021,150,DARE , ,22/01/2021, ,4.98,69.60000000000001,102024 BANCA DELLA CAMPAN,,,,,
8.33.011,ONERI E COMMISSIONI BANCARIE ,25/01/2021,150,DARE , ,25/01/2021, ,2.49,72.09,102024 BANCA DELLA CAMPAN,,,,,
8.33.011,ONERI E COMMISSIONI BANCARIE ,27/01/2021,150,BONIFICO S/FATT. , ,27/01/2021, ,0.83,72.92, diversi a diversi,,,,,
8.33.011,ONERI E COMMISSIONI BANCARIE ,01/02/2021,150,DARE , ,01/02/2021, ,16.6,89.52000000000001,102024 BANCA DELLA CAMPAN,,,,,
8.33.011,ONERI E COMMISSIONI BANCARIE ,01/02/2021,150,DARE , ,01/02/2021, ,17.92,107.44,102038 UNICREDIT BANCA,,,,,
8.33.011,ONERI E COMMISSIONI BANCARIE ,02/02/2021,150,DARE , ,02/02/2021, ,4.15,111.59,102024 BANCA DELLA CAMPAN,,,,,
8.33.011,ONERI E COMMISSIONI BANCARIE ,02/02/2021,150,DARE , ,02/02/2021, ,13.28,124.87,102024 BANCA DELLA CAMPAN,,,,,
8.33.011,ONERI E COMMISSIONI BANCARIE ,04/02/2021,150,DARE , ,04/02/2021, ,1.66,126.53,102024 BANCA DELLA CAMPAN,,,,,
8.33.011,ONERI E COMMISSIONI BANCARIE ,04/02/2021,150,BONIFICO C/FATT. , ,04/02/2021, ,14.16,140.69, diversi a diversi,,,,,
8.33.011,ONERI E COMMISSIONI BANCARIE ,08/02/2021,150,BONIFICO S/FATT.N.1, ,08/02/2021, ,0.83,141.52, diversi a diversi,,,,,
8.33.011,ONERI E COMMISSIONI BANCARIE ,09/02/2021,150,DARE , ,09/02/2021, ,2.49,144.01,102024 BANCA DELLA CAMPAN,,,,,
8.33.011,ONERI E COMMISSIONI BANCARIE ,10/02/2021,150,ADDEB.UTENZE , ,10/02/2021, ,1.1,145.11, diversi a diversi,,,,,
8.33.011,ONERI E COMMISSIONI BANCARIE ,11/02/2021,150,DARE , ,11/02/2021, ,1.66,146.77,102024 BANCA DELLA CAMPAN,,,,,
8.33.011,ONERI E COMMISSIONI BANCARIE ,12/02/2021,150,DARE , ,12/02/2021, ,0.83,147.6000000000001,102024 BANCA DELLA CAMPAN,,,,,
8.33.011,ONERI E COMMISSIONI BANCARIE ,13/02/2021,150,ADDEB.CARTA CRED. , ,13/02/2021, ,1.5,149.1000000000001,102024 BANCA DELLA CAMPAN,,,,,
8.33.011,ONERI E COMMISSIONI BANCARIE ,17/02/2021,150,DARE , ,17/02/2021, ,8.3,157.4000000000001,102024 BANCA DELLA CAMPAN,,,,,
8.33.011,ONERI E COMMISSIONI BANCARIE ,18/02/2021,150,DARE , ,18/02/2021, ,1.66,159.0600000000001,102024 BANCA DELLA CAMPAN,,,,,
8.33.011,ONERI E COMMISSIONI BANCARIE ,22/02/2021,150,DARE , ,22/02/2021, ,1.66,160.7200000000001,102024 BANCA DELLA CAMPAN,,,,,
8.33.011,ONERI E COMMISSIONI BANCARIE ,25/02/2021,150,DARE , ,25/02/2021, ,2.49,163.2100000000001,102024 BANCA DELLA CAMPAN,,,,,
8.33.011,ONERI E COMMISSIONI BANCARIE ,26/02/2021,150,DARE , ,26/02/2021, ,2.49,165.7000000000001,102024 BANCA DELLA CAMPAN,,,,,
8.33.011,ONERI E COMMISSIONI BANCARIE ,01/03/2021,150,DARE , ,01/03/2021, ,17.92,183.6200000000001,102038 UNICREDIT BANCA,,,,,
8.33.011,ONERI E COMMISSIONI BANCARIE ,03/03/2021,150,DARE , ,03/03/2021, ,16.6,200.2200000000001,102024 BANCA DELLA CAMPAN,,,,,
8.33.011,ONERI E COMMISSIONI BANCARIE ,03/03/2021,150,DARE , ,03/03/2021, ,14.11,214.33,102024 BANCA DELLA CAMPAN,,,,,
8.33.011,ONERI E COMMISSIONI BANCARIE ,03/03/2021,150,ADDEB.FATT. , ,03/03/2021, ,1.1,215.43, diversi a diversi,,,,,
8.33.011,ONERI E COMMISSIONI BANCARIE ,04/03/2021,150,DARE , ,04/03/2021, ,33.78,249.21, diversi a diversi,,,,,
8.33.011,ONERI E COMMISSIONI BANCARIE ,04/03/2021,150,BONIFICO C/FATT. , ,04/03/2021, ,1.66,250.87, diversi a diversi,,,,,
8.33.011,ONERI E COMMISSIONI BANCARIE ,09/03/2021,150,DARE , ,09/03/2021, ,2.49,253.36,102024 BANCA DELLA CAMPAN,,,,,
8.33.011,ONERI E COMMISSIONI BANCARIE ,10/03/2021,150,DARE , ,10/03/2021, ,1.66,255.02,102024 BANCA DELLA CAMPAN,,,,,
8.33.011,ONERI E COMMISSIONI BANCARIE ,13/03/2021,150,S/FATT.ADDEB.CARTA , ,13/03/2021, ,0.85,255.87,102024 BANCA DELLA CAMPAN,,,,,
8.33.011,ONERI E COMMISSIONI BANCARIE ,16/03/2021,150,DARE , ,16/03/2021, ,5.81,261.68,102024 BANCA DELLA CAMPAN,,,,,
8.33.011,ONERI E COMMISSIONI BANCARIE ,18/03/2021,150,C/FATT.BONIFICO , ,18/03/2021, ,0.83,262.51, diversi a diversi,,,,,
8.33.011,ONERI E COMMISSIONI BANCARIE ,22/03/2021,150,DARE , ,22/03/2021, ,2.49,265.0,102024 BANCA DELLA CAMPAN,,,,,
8.33.011,ONERI E COMMISSIONI BANCARIE ,24/03/2021,150,DARE , ,24/03/2021, ,1.1,266.1,102024 BANCA DELLA CAMPAN,,,,,
8.33.011,ONERI E COMMISSIONI BANCARIE ,25/03/2021,150,BONIFICO S/FATT. , ,25/03/2021, ,0.83,266.93, diversi a diversi,,,,,
8.33.011,ONERI E COMMISSIONI BANCARIE ,25/03/2021,150,DARE , ,25/03/2021, ,1.1,268.03,102024 BANCA DELLA CAMPAN,,,,,
8.33.011,ONERI E COMMISSIONI BANCARIE ,30/03/2021,150,DARE , ,30/03/2021, ,4.15,272.18,102024 BANCA DELLA CAMPAN,,,,,
8.33.011,ONERI E COMMISSIONI BANCARIE ,01/04/2021,150,DARE , ,01/04/2021, ,21.58,293.76,102024 BANCA DELLA CAMPAN,,,,,
8.33.011,ONERI E COMMISSIONI BANCARIE ,01/04/2021,150,DARE , ,01/04/2021, ,10.79,304.55,102024 BANCA DELLA CAMPAN,,,,,
8.33.011,ONERI E COMMISSIONI BANCARIE ,01/04/2021,150,DARE , ,01/04/2021, ,17.92,322.47,102038 UNICREDIT BANCA,,,,,
8.33.011,ONERI E COMMISSIONI BANCARIE ,06/04/2021,150,DARE , ,06/04/2021, ,1.1,323.5700000000001, diversi a diversi,,,,,
8.33.011,ONERI E COMMISSIONI BANCARIE ,07/04/2021,150,BONIFICO S/FATT. , ,07/04/2021, ,0.83,324.4, diversi a diversi,,,,,
8.33.011,ONERI E COMMISSIONI BANCARIE ,07/04/2021,150,DARE , ,07/04/2021, ,0.83,325.23, diversi a diversi,,,,,
8.33.011,ONERI E COMMISSIONI BANCARIE ,07/04/2021,150,DARE , ,07/04/2021, ,1.1,326.33, diversi a diversi,,,,,
8.33.011,ONERI E COMMISSIONI BANCARIE ,07/04/2021,150,DARE , ,07/04/2021, ,1.1,327.4300000000001, diversi a diversi,,,,,
8.33.011,ONERI E COMMISSIONI BANCARIE ,08/04/2021,150,DARE , ,31/03/2021, ,170.18,497.6100000000001,102024 BANCA DELLA CAMPAN,,,,,
8.33.011,ONERI E COMMISSIONI BANCARIE ,08/04/2021,150,DARE , ,08/04/2021, ,1.1,498.7100000000001,102024 BANCA DELLA CAMPAN,,,,,
8.33.011,ONERI E COMMISSIONI BANCARIE ,09/04/2021,150,ADDEB.UTENZE , ,09/04/2021, ,1.1,499.8100000000001, diversi a diversi,,,,,
8.33.011,ONERI E COMMISSIONI BANCARIE ,09/04/2021,150,DARE , ,09/04/2021, ,1.1,500.9100000000001, diversi a diversi,,,,,
8.33.011,ONERI E COMMISSIONI BANCARIE ,09/04/2021,150,DARE , ,09/04/2021, ,1.66,502.5700000000002, diversi a diversi,,,,,
8.33.011,ONERI E COMMISSIONI BANCARIE ,12/04/2021,150,S/FATTT.N.9 BONIFIC, ,12/04/2021, ,1.66,504.2300000000002, diversi a diversi,,,,,
8.33.011,ONERI E COMMISSIONI BANCARIE ,14/04/2021,150,S/FATT.N.1 BONIFICO, ,14/04/2021, ,35.97,540.2000000000002, diversi a diversi,,,,,
8.33.011,ONERI E COMMISSIONI BANCARIE ,14/04/2021,150,BONIFICO S/FATT. , ,14/04/2021, ,0.83,541.0300000000002, diversi a diversi,,,,,
8.33.011,ONERI E COMMISSIONI BANCARIE ,16/04/2021,150,DARE , ,16/04/2021, ,2.49,543.5200000000002,102024 BANCA DELLA CAMPAN,,,,,
8.33.011,ONERI E COMMISSIONI BANCARIE ,17/04/2021,150,RATA INTERESSI MUTU, ,17/04/2021, ,2.75,546.2700000000002,102024 BANCA DELLA CAMPAN,,,,,
8.33.011,ONERI E COMMISSIONI BANCARIE ,22/04/2021,150,DARE , ,22/04/2021, ,0.83,547.1000000000003,102024 BANCA DELLA CAMPAN,,,,,
8.33.011,ONERI E COMMISSIONI BANCARIE ,22/04/2021,150,DARE , ,22/04/2021, ,1.1,548.2000000000003,102024 BANCA DELLA CAMPAN,,,,,
8.33.011,ONERI E COMMISSIONI BANCARIE ,26/04/2021,150,DARE , ,26/04/2021, ,4.15,552.3500000000003,102024 BANCA DELLA CAMPAN,,,,,
8.33.011,ONERI E COMMISSIONI BANCARIE ,27/04/2021,150,DARE , ,27/04/2021, ,1.66,554.0100000000002,102024 BANCA DELLA CAMPAN,,,,,
8.33.011,ONERI E COMMISSIONI BANCARIE ,28/04/2021,150,S/FATT.BONIFICO , ,28/04/2021, ,0.83,554.8400000000003, diversi a diversi,,,,,
8.33.011,ONERI E COMMISSIONI BANCARIE ,29/04/2021,150,DARE , ,29/04/2021, ,1.66,556.5000000000002,102024 BANCA DELLA CAMPAN,,,,,
8.33.011,ONERI E COMMISSIONI BANCARIE ,03/05/2021,150,ADDEBITO UTENZE , ,03/05/2021, ,1.1,557.6000000000003, diversi a diversi,,,,,
8.33.011,ONERI E COMMISSIONI BANCARIE ,03/05/2021,150,DARE , ,03/05/2021, ,16.6,574.2000000000003,102024 BANCA DELLA CAMPAN,,,,,
8.33.011,ONERI E COMMISSIONI BANCARIE ,03/05/2021,150,DARE , ,03/05/2021, ,3.32,577.5200000000003,102024 BANCA DELLA CAMPAN,,,,,
8.33.011,ONERI E COMMISSIONI BANCARIE ,03/05/2021,150,DARE , ,01/05/2021, ,17.92,595.4400000000003,102038 UNICREDIT BANCA,,,,,
8.33.011,ONERI E COMMISSIONI BANCARIE ,04/05/2021,150,DARE , ,04/05/2021, ,9.96,605.4000000000003,102024 BANCA DELLA CAMPAN,,,,,
8.33.011,ONERI E COMMISSIONI BANCARIE ,05/05/2021,150,DARE , ,05/05/2021, ,1.66,607.0600000000003,102024 BANCA DELLA CAMPAN,,,,,
8.33.011,ONERI E COMMISSIONI BANCARIE ,06/05/2021,150,DARE , ,06/05/2021, ,1.66,608.7200000000003,102024 BANCA DELLA CAMPAN,,,,,
8.33.011,ONERI E COMMISSIONI BANCARIE ,10/05/2021,150,DARE , ,10/05/2021, ,1.66,610.3800000000002,102024 BANCA DELLA CAMPAN,,,,,
8.33.011,ONERI E COMMISSIONI BANCARIE ,11/05/2021,150,BONIFICO S/FATT. , ,11/05/2021, ,0.83,611.2100000000003, diversi a diversi,,,,,
8.33.011,ONERI E COMMISSIONI BANCARIE ,17/05/2021,150,ADDEB.RATA INTERESS, ,17/05/2021, ,2.75,613.9600000000003,102024 BANCA DELLA CAMPAN,,,,,
8.33.011,ONERI E COMMISSIONI BANCARIE ,19/05/2021,150,BONIFICO S/FATT. , ,19/05/2021, ,22.18,636.1400000000002, diversi a diversi,,,,,
8.33.011,ONERI E COMMISSIONI BANCARIE ,21/05/2021,150,DARE , ,21/05/2021, ,5.81,641.9500000000002,102024 BANCA DELLA CAMPAN,,,,,
8.33.011,ONERI E COMMISSIONI BANCARIE ,24/05/2021,150,BONIFICO S/FATT. , ,24/05/2021, ,23.07,665.0200000000002, diversi a diversi,,,,,
8.33.011,ONERI E COMMISSIONI BANCARIE ,27/05/2021,150,RIMB.FORMAZ.BORGHES, ,27/05/2021, ,0.83,665.8500000000003, diversi a diversi,,,,,
8.33.011,ONERI E COMMISSIONI BANCARIE ,31/05/2021,150,DARE , ,31/05/2021, ,1.66,667.5100000000002,102024 BANCA DELLA CAMPAN,,,,,
8.33.011,ONERI E COMMISSIONI BANCARIE ,01/06/2021,150,DARE , ,01/06/2021, ,21.58,689.0900000000003,102024 BANCA DELLA CAMPAN,,,,,
8.33.011,ONERI E COMMISSIONI BANCARIE ,01/06/2021,150,DARE , ,01/06/2021, ,7.47,696.5600000000003,102024 BANCA DELLA CAMPAN,,,,,
8.33.011,ONERI E COMMISSIONI BANCARIE ,01/06/2021,150,DARE , ,01/06/2021, ,17.92,714.4800000000002,102038 UNICREDIT BANCA,,,,,
8.33.011,ONERI E COMMISSIONI BANCARIE ,04/06/2021,150,DARE , ,04/06/2021, ,1.66,716.1400000000002,102024 BANCA DELLA CAMPAN,,,,,
8.33.011,ONERI E COMMISSIONI BANCARIE ,07/06/2021,150,DARE , ,07/06/2021, ,0.83,716.9700000000003,102024 BANCA DELLA CAMPAN,,,,,
8.33.011,ONERI E COMMISSIONI BANCARIE ,08/06/2021,150,S/FATT.BONIFICO , ,08/06/2021, ,0.83,717.8000000000003, diversi a diversi,,,,,
8.33.011,ONERI E COMMISSIONI BANCARIE ,09/06/2021,150,ADDEB.UTENZE , ,09/06/2021, ,1.1,718.9000000000003, diversi a diversi,,,,,
8.33.011,ONERI E COMMISSIONI BANCARIE ,11/06/2021,150,DARE , ,11/06/2021, ,4.98,723.8800000000003,102024 BANCA DELLA CAMPAN,,,,,
8.33.011,ONERI E COMMISSIONI BANCARIE ,11/06/2021,150,DARE , ,11/06/2021, ,0.83,724.7100000000004,102024 BANCA DELLA CAMPAN,,,,,
8.33.011,ONERI E COMMISSIONI BANCARIE ,16/06/2021,150,BONIFICO S/FATT. , ,16/06/2021, ,0.83,725.5400000000004, diversi a diversi,,,,,
8.33.011,ONERI E COMMISSIONI BANCARIE ,16/06/2021,150,DARE , ,16/06/2021, ,0.83,726.3700000000005,102024 BANCA DELLA CAMPAN,,,,,
8.33.011,ONERI E COMMISSIONI BANCARIE ,17/06/2021,150,ADDEB.RATA INTERESS, ,17/06/2021, ,2.75,729.1200000000005,102024 BANCA DELLA CAMPAN,,,,,
8.33.011,ONERI E COMMISSIONI BANCARIE ,18/06/2021,150,BONIFICO S/FATT. , ,18/06/2021, ,0.83,729.9500000000005, diversi a diversi,,,,,
8.33.011,ONERI E COMMISSIONI BANCARIE ,22/06/2021,150,DARE , ,22/06/2021, ,5.81,735.7600000000004,102024 BANCA DELLA CAMPAN,,,,,
8.33.011,ONERI E COMMISSIONI BANCARIE ,23/06/2021,150,DARE , ,23/06/2021, ,1.66,737.4200000000004,102024 BANCA DELLA CAMPAN,,,,,
8.33.011,ONERI E COMMISSIONI BANCARIE ,23/06/2021,150,BONIFICO S/FATT. , ,23/06/2021, ,0.83,738.2500000000005, diversi a diversi,,,,,
8.33.011,ONERI E COMMISSIONI BANCARIE ,25/06/2021,150,C/RETRIBUZ.BONIFICO, ,25/06/2021, ,0.83,739.0800000000005, diversi a diversi,,,,,
8.33.011,ONERI E COMMISSIONI BANCARIE ,29/06/2021,150,GIROCONTO DA C/C A , ,29/06/2021, ,0.83,739.9100000000005, diversi a diversi,,,,,
8.33.011,ONERI E COMMISSIONI BANCARIE ,30/06/2021,150,ADDEB.UTENZE , ,30/06/2021, ,1.1,741.0100000000006, diversi a diversi,,,,,
8.33.011,ONERI E COMMISSIONI BANCARIE ,01/07/2021,150,DARE , ,01/07/2021, ,17.92,758.9300000000005,102038 UNICREDIT BANCA,,,,,
8.33.011,ONERI E COMMISSIONI BANCARIE ,02/07/2021,150,DARE , ,02/07/2021, ,18.26,777.1900000000005,102024 BANCA DELLA CAMPAN,,,,,
8.33.011,ONERI E COMMISSIONI BANCARIE ,05/07/2021,150,DARE , ,05/07/2021, ,18.26,795.4500000000005,102024 BANCA DELLA CAMPAN,,,,,
8.33.011,ONERI E COMMISSIONI BANCARIE ,06/07/2021,150,DARE , ,06/07/2021, ,5.81,801.2600000000004,102024 BANCA DELLA CAMPAN,,,,,
8.33.011,ONERI E COMMISSIONI BANCARIE ,07/07/2021,150,DARE , ,30/06/2021, ,188.36,989.6200000000005,102024 BANCA DELLA CAMPAN,,,,,
8.33.011,ONERI E COMMISSIONI BANCARIE ,07/07/2021,150,S/FATT.N.6 BONIFICO, ,07/07/2021, ,0.83,990.4500000000005, diversi a diversi,,,,,
8.33.011,ONERI E COMMISSIONI BANCARIE ,08/07/2021,150,DARE , ,08/07/2021, ,1.66,992.1100000000005,102024 BANCA DELLA CAMPAN,,,,,
8.33.011,ONERI E COMMISSIONI BANCARIE ,12/07/2021,150,DARE , ,12/07/2021, ,1.66,993.7700000000004,102024 BANCA DELLA CAMPAN,,,,,
8.33.011,ONERI E COMMISSIONI BANCARIE ,13/07/2021,150,DARE , ,13/07/2021, ,2.49,996.2600000000004,102024 BANCA DELLA CAMPAN,,,,,
8.33.011,ONERI E COMMISSIONI BANCARIE ,15/07/2021,150,DARE , ,15/07/2021, ,3.32,999.5800000000005,102024 BANCA DELLA CAMPAN,,,,,
8.33.011,ONERI E COMMISSIONI BANCARIE ,15/07/2021,150,ANAC PAGOPA , ,15/07/2021, ,1.0,1000.58,102024 BANCA DELLA CAMPAN,,,,,
8.33.011,ONERI E COMMISSIONI BANCARIE ,15/07/2021,150,ANAC PAGOPA , ,15/07/2021, ,1.0,1001.58,102024 BANCA DELLA CAMPAN,,,,,
8.33.011,ONERI E COMMISSIONI BANCARIE ,15/07/2021,150,ANAC PAGOPA , ,15/07/2021, ,1.0,1002.58,102024 BANCA DELLA CAMPAN,,,,,
8.33.011,ONERI E COMMISSIONI BANCARIE ,15/07/2021,150,S/FATT.CARTA CRED. , ,15/07/2021, ,0.85,1003.430000000001,102024 BANCA DELLA CAMPAN,,,,,
8.33.011,ONERI E COMMISSIONI BANCARIE ,16/07/2021,150,ADDEB.RATA MUTUO , ,16/07/2021, ,2.75,1006.180000000001,102024 BANCA DELLA CAMPAN,,,,,
8.33.011,ONERI E COMMISSIONI BANCARIE ,19/07/2021,150,DARE , ,19/07/2021, ,1.66,1007.84,102024 BANCA DELLA CAMPAN,,,,,
8.33.011,ONERI E COMMISSIONI BANCARIE ,21/07/2021,150,DARE , ,21/07/2021, ,4.15,1011.99,102024 BANCA DELLA CAMPAN,,,,,
8.33.011,ONERI E COMMISSIONI BANCARIE ,22/07/2021,150,DARE , ,22/07/2021, ,8.3,1020.29,102024 BANCA DELLA CAMPAN,,,,,
8.33.011,ONERI E COMMISSIONI BANCARIE ,23/07/2021,150,BONIFICO S/FATT. , ,23/07/2021, ,0.83,1021.12, diversi a diversi,,,,,
8.33.011,ONERI E COMMISSIONI BANCARIE ,27/07/2021,150,S/PRESTAZ.LAEZZA , ,27/07/2021, ,0.83,1021.950000000001, diversi a diversi,,,,,
8.33.011,ONERI E COMMISSIONI BANCARIE ,29/07/2021,150,DARE , ,29/07/2021, ,11.62,1033.57,102024 BANCA DELLA CAMPAN,,,,,
8.33.011,ONERI E COMMISSIONI BANCARIE ,29/07/2021,150,DARE , ,29/07/2021, ,18.26,1051.83,102024 BANCA DELLA CAMPAN,,,,,
8.33.011,ONERI E COMMISSIONI BANCARIE ,30/07/2021,150,BONIFICO S/FATT. , ,30/07/2021, ,0.83,1052.66, diversi a diversi,,,,,
8.33.011,ONERI E COMMISSIONI BANCARIE ,02/08/2021,150,DARE , ,01/08/2021, ,17.92,1070.58,102038 UNICREDIT BANCA,,,,,
8.33.011,ONERI E COMMISSIONI BANCARIE ,03/08/2021,150,BONIFICO S/FATT. , ,03/08/2021, ,0.83,1071.41, diversi a diversi,,,,,
8.33.011,ONERI E COMMISSIONI BANCARIE ,11/08/2021,150,ADDEB.UTENZE , ,11/08/2021, ,1.1,1072.51, diversi a diversi,,,,,
8.33.011,ONERI E COMMISSIONI BANCARIE ,12/08/2021,150,BONIFICO ACC/FATTUR, ,12/08/2021, ,0.83,1073.34, diversi a diversi,,,,,
8.33.011,ONERI E COMMISSIONI BANCARIE ,14/08/2021,150,PAG.ANAC CARTA CRED, ,14/08/2021, ,1.0,1074.34,102024 BANCA DELLA CAMPAN,,,,,
8.33.011,ONERI E COMMISSIONI BANCARIE ,14/08/2021,150,PAG.ANAC CARTA CRED, ,14/08/2021, ,1.0,1075.34,102024 BANCA DELLA CAMPAN,,,,,
8.33.011,ONERI E COMMISSIONI BANCARIE ,14/08/2021,150,PAG.ANAC CARTA CRED, ,14/08/2021, ,1.0,1076.34,102024 BANCA DELLA CAMPAN,,,,,
8.33.011,ONERI E COMMISSIONI BANCARIE ,14/08/2021,150,PAG.ANAC CARTA CRED, ,14/08/2021, ,1.0,1077.34,102024 BANCA DELLA CAMPAN,,,,,
8.33.011,ONERI E COMMISSIONI BANCARIE ,14/08/2021,150,PAG.ANAC CARTA CRED, ,14/08/2021, ,1.0,1078.34,102024 BANCA DELLA CAMPAN,,,,,
8.33.011,ONERI E COMMISSIONI BANCARIE ,14/08/2021,150,PAG.ANAC CARTA CRED, ,14/08/2021, ,0.85,1079.19,102024 BANCA DELLA CAMPAN,,,,,
8.33.011,ONERI E COMMISSIONI BANCARIE ,17/08/2021,150,ADDEB.RATA MUTUO , ,17/08/2021, ,2.75,1081.94,102024 BANCA DELLA CAMPAN,,,,,
8.33.011,ONERI E COMMISSIONI BANCARIE ,17/08/2021,150,C/RETRIBUZ.BONIFICO, ,17/08/2021, ,0.83,1082.77, diversi a diversi,,,,,
8.33.011,ONERI E COMMISSIONI BANCARIE ,18/08/2021,150,CAUZIONE LOCAZ.SERE, ,18/08/2021, ,0.83,1083.6, diversi a diversi,,,,,
8.33.011,ONERI E COMMISSIONI BANCARIE ,31/08/2021,150,ADDEB.UTENZE , ,31/08/2021, ,1.1,1084.7, diversi a diversi,,,,,
8.33.011,ONERI E COMMISSIONI BANCARIE ,31/08/2021,150,DARE , ,31/08/2021, ,17.43,1102.13,102024 BANCA DELLA CAMPAN,,,,,
8.33.011,ONERI E COMMISSIONI BANCARIE ,01/09/2021,150,DARE , ,01/09/2021, ,21.58,1123.71,102024 BANCA DELLA CAMPAN,,,,,
8.33.011,ONERI E COMMISSIONI BANCARIE ,01/09/2021,150,DARE , ,01/09/2021, ,2.49,1126.2,102024 BANCA DELLA CAMPAN,,,,,
8.33.011,ONERI E COMMISSIONI BANCARIE ,01/09/2021,150,DARE , ,01/09/2021, ,17.92,1144.12,102038 UNICREDIT BANCA,,,,,
8.33.011,ONERI E COMMISSIONI BANCARIE ,02/09/2021,150,DARE , ,02/09/2021, ,3.32,1147.44,102024 BANCA DELLA CAMPAN,,,,,
8.33.011,ONERI E COMMISSIONI BANCARIE ,09/09/2021,150,DARE , ,09/09/2021, ,2.49,1149.93,102024 BANCA DELLA CAMPAN,,,,,
8.33.011,ONERI E COMMISSIONI BANCARIE ,13/09/2021,150,DARE , ,13/09/2021, ,1.66,1151.59,102024 BANCA DELLA CAMPAN,,,,,
8.33.011,ONERI E COMMISSIONI BANCARIE ,14/09/2021,150,BONIFICO S/FATT.12 , ,14/09/2021, ,0.83,1152.42, diversi a diversi,,,,,
8.33.011,ONERI E COMMISSIONI BANCARIE ,14/09/2021,150,S/FATT.ADDEB-CARTA , ,14/09/2021, ,0.85,1153.27,102024 BANCA DELLA CAMPAN,,,,,
8.33.011,ONERI E COMMISSIONI BANCARIE ,17/09/2021,150,DARE , ,17/09/2021, ,6.64,1159.91,102024 BANCA DELLA CAMPAN,,,,,
8.33.011,ONERI E COMMISSIONI BANCARIE ,17/09/2021,150,ADDEB.RATA MUTUO , ,17/09/2021, ,2.75,1162.66,102024 BANCA DELLA CAMPAN,,,,,
8.33.011,ONERI E COMMISSIONI BANCARIE ,22/09/2021,150,DARE , ,22/09/2021, ,1.66,1164.32,102024 BANCA DELLA CAMPAN,,,,,
8.33.011,ONERI E COMMISSIONI BANCARIE ,24/09/2021,150,BONIFICO S/FATT. , ,24/09/2021, ,0.83,1165.15, diversi a diversi,,,,,
8.33.011,ONERI E COMMISSIONI BANCARIE ,27/09/2021,150,DARE , ,27/09/2021, ,1.66,1166.81,102024 BANCA DELLA CAMPAN,,,,,
8.33.011,ONERI E COMMISSIONI BANCARIE ,28/09/2021,150,DARE , ,28/09/2021, ,1.66,1168.47,102024 BANCA DELLA CAMPAN,,,,,
8.33.011,ONERI E COMMISSIONI BANCARIE ,28/09/2021,150,DARE , ,28/09/2021, ,19.09,1187.56,102024 BANCA DELLA CAMPAN,,,,,
8.33.011,ONERI E COMMISSIONI BANCARIE ,29/09/2021,150,DARE , ,29/09/2021, ,4.98,1192.54,102024 BANCA DELLA CAMPAN,,,,,
8.33.011,ONERI E COMMISSIONI BANCARIE ,30/09/2021,150,BONIFICO S/FATT. , ,30/09/2021, ,0.83,1193.37, diversi a diversi,,,,,
8.33.011,ONERI E COMMISSIONI BANCARIE ,01/10/2021,150,C/RETRIB.BONIFICO , ,01/10/2021, ,0.83,1194.2, diversi a diversi,,,,,
8.33.011,ONERI E COMMISSIONI BANCARIE ,01/10/2021,150,DARE , ,01/10/2021, ,17.92,1212.12,102038 UNICREDIT BANCA,,,,,
8.33.011,ONERI E COMMISSIONI BANCARIE ,05/10/2021,150,DARE , ,05/10/2021, ,29.42,1241.54,102024 BANCA DELLA CAMPAN,,,,,
8.33.011,ONERI E COMMISSIONI BANCARIE ,05/10/2021,150,DARE , ,05/10/2021, ,1.66,1243.2,102024 BANCA DELLA CAMPAN,,,,,
8.33.011,ONERI E COMMISSIONI BANCARIE ,06/10/2021,150,DARE , ,30/09/2021, ,224.0,1467.2,102024 BANCA DELLA CAMPAN,,,,,
8.33.011,ONERI E COMMISSIONI BANCARIE ,06/10/2021,150,DARE , ,06/10/2021, ,1.66,1468.86,102024 BANCA DELLA CAMPAN,,,,,
8.33.011,ONERI E COMMISSIONI BANCARIE ,07/10/2021,150,DARE , ,07/10/2021, ,0.83,1469.69,102024 BANCA DELLA CAMPAN,,,,,
8.33.011,ONERI E COMMISSIONI BANCARIE ,07/10/2021,150,S/FATT.N.191-232 BO, ,07/10/2021, ,0.83,1470.52, diversi a diversi,,,,,
8.33.011,ONERI E COMMISSIONI BANCARIE ,08/10/2021,150,DARE , ,08/10/2021, ,3.32,1473.84,102024 BANCA DELLA CAMPAN,,,,,
8.33.011,ONERI E COMMISSIONI BANCARIE ,12/10/2021,150,ADDEB.UTENZE , ,12/10/2021, ,1.1,1474.94, diversi a diversi,,,,,
8.33.011,ONERI E COMMISSIONI BANCARIE ,12/10/2021,150,DARE , ,12/10/2021, ,11.0,1485.94,102024 BANCA DELLA CAMPAN,,,,,
8.33.011,ONERI E COMMISSIONI BANCARIE ,14/10/2021,150,DARE , ,14/10/2021, ,3.32,1489.26,102024 BANCA DELLA CAMPAN,,,,,
8.33.011,ONERI E COMMISSIONI BANCARIE ,15/10/2021,150,BONIFICO S/FATT. , ,15/10/2021, ,0.83,1490.09, diversi a diversi,,,,,
8.33.011,ONERI E COMMISSIONI BANCARIE ,15/10/2021,150,S/FATT.ADDEB.CARTA , ,15/10/2021, ,0.85,1490.94,102024 BANCA DELLA CAMPAN,,,,,
8.33.011,ONERI E COMMISSIONI BANCARIE ,17/10/2021,150,ADDEB.RATA FINANZ. , ,17/10/2021, ,2.75,1493.69,102024 BANCA DELLA CAMPAN,,,,,
8.33.011,ONERI E COMMISSIONI BANCARIE ,22/10/2021,150,DARE , ,22/10/2021, ,4.98,1498.67,102024 BANCA DELLA CAMPAN,,,,,
8.33.011,ONERI E COMMISSIONI BANCARIE ,25/10/2021,150,GIROCONTO DA C/C A , ,25/10/2021, ,2.27,1500.94,102038 UNICREDIT BANCA,,,,,
8.33.011,ONERI E COMMISSIONI BANCARIE ,25/10/2021,150,DARE , ,25/10/2021, ,0.83,1501.77,102024 BANCA DELLA CAMPAN,,,,,
8.33.011,ONERI E COMMISSIONI BANCARIE ,26/10/2021,150,DARE , ,26/10/2021, ,10.79,1512.559999999999,102024 BANCA DELLA CAMPAN,,,,,
8.33.011,ONERI E COMMISSIONI BANCARIE ,26/10/2021,150,DARE , ,26/10/2021, ,1.66,1514.22,102024 BANCA DELLA CAMPAN,,,,,
8.33.011,ONERI E COMMISSIONI BANCARIE ,28/10/2021,150,DARE , ,28/10/2021, ,5.81,1520.03,102024 BANCA DELLA CAMPAN,,,,,
8.33.011,ONERI E COMMISSIONI BANCARIE ,29/10/2021,150,ADDEB.UTENZE , ,29/10/2021, ,1.1,1521.129999999999, diversi a diversi,,,,,
8.33.011,ONERI E COMMISSIONI BANCARIE ,29/10/2021,150,BONIFICO S/FATT. , ,29/10/2021, ,0.83,1521.959999999999, diversi a diversi,,,,,
8.33.011,ONERI E COMMISSIONI BANCARIE ,01/11/2021,150,DARE , ,01/11/2021, ,17.92,1539.879999999999,102038 UNICREDIT BANCA,,,,,
8.33.011,ONERI E COMMISSIONI BANCARIE ,02/11/2021,150,DARE , ,02/11/2021, ,22.41,1562.29,102024 BANCA DELLA CAMPAN,,,,,
8.33.011,ONERI E COMMISSIONI BANCARIE ,02/11/2021,150,BONIFICO S/FATT. , ,02/11/2021, ,0.83,1563.119999999999, diversi a diversi,,,,,
8.33.011,ONERI E COMMISSIONI BANCARIE ,04/11/2021,150,DARE , ,04/11/2021, ,1.66,1564.78,102024 BANCA DELLA CAMPAN,,,,,
8.33.011,ONERI E COMMISSIONI BANCARIE ,09/11/2021,150,DARE , ,09/11/2021, ,4.98,1569.76,102024 BANCA DELLA CAMPAN,,,,,
8.33.011,ONERI E COMMISSIONI BANCARIE ,10/11/2021,150,DARE , ,10/11/2021, ,0.83,1570.589999999999, diversi a diversi,,,,,
8.33.011,ONERI E COMMISSIONI BANCARIE ,11/11/2021,150,DARE , ,11/11/2021, ,0.83,1571.419999999999,102024 BANCA DELLA CAMPAN,,,,,
8.33.011,ONERI E COMMISSIONI BANCARIE ,11/11/2021,150,DARE , ,11/11/2021, ,1.66,1573.079999999999,102024 BANCA DELLA CAMPAN,,,,,
8.33.011,ONERI E COMMISSIONI BANCARIE ,12/11/2021,150,GIROCONTO DA C/C A , ,12/11/2021, ,2.27,1575.349999999999,102038 UNICREDIT BANCA,,,,,
8.33.011,ONERI E COMMISSIONI BANCARIE ,12/11/2021,150,DARE , ,12/11/2021, ,4.15,1579.5,102024 BANCA DELLA CAMPAN,,,,,
8.33.011,ONERI E COMMISSIONI BANCARIE ,13/11/2021,150,ISCR.IEEE CARTA CRE, ,12/11/2021, ,0.85,1580.349999999999,102024 BANCA DELLA CAMPAN,,,,,
8.33.011,ONERI E COMMISSIONI BANCARIE ,16/11/2021,150,DARE , ,16/11/2021, ,3.32,1583.669999999999,102024 BANCA DELLA CAMPAN,,,,,
8.33.011,ONERI E COMMISSIONI BANCARIE ,17/11/2021,150,ADDEB.RATA MUTUO , ,17/11/2021, ,2.75,1586.419999999999,102024 BANCA DELLA CAMPAN,,,,,
8.33.011,ONERI E COMMISSIONI BANCARIE ,18/11/2021,150,BONIFICO S/FATT. , ,18/11/2021, ,0.83,1587.249999999999, diversi a diversi,,,,,
8.33.011,ONERI E COMMISSIONI BANCARIE ,19/11/2021,150,DARE , ,19/11/2021, ,2.49,1589.739999999999,102024 BANCA DELLA CAMPAN,,,,,
8.33.011,ONERI E COMMISSIONI BANCARIE ,22/11/2021,150,S/FATT.BONIFICO , ,22/11/2021, ,0.83,1590.569999999999, diversi a diversi,,,,,
8.33.011,ONERI E COMMISSIONI BANCARIE ,23/11/2021,150,BONIFICO S/FATT. , ,23/11/2021, ,0.83,1591.399999999999, diversi a diversi,,,,,
8.33.011,ONERI E COMMISSIONI BANCARIE ,25/11/2021,150,DARE , ,25/11/2021, ,5.81,1597.209999999999,102024 BANCA DELLA CAMPAN,,,,,
8.33.011,ONERI E COMMISSIONI BANCARIE ,29/11/2021,150,BONIFICO S/FATT. , ,29/11/2021, ,0.83,1598.039999999999, diversi a diversi,,,,,
8.33.011,ONERI E COMMISSIONI BANCARIE ,30/11/2021,150,DARE , ,30/11/2021, ,1.66,1599.699999999999,102024 BANCA DELLA CAMPAN,,,,,
8.33.011,ONERI E COMMISSIONI BANCARIE ,01/12/2021,150,DARE , ,01/12/2021, ,17.92,1617.619999999999,102038 UNICREDIT BANCA,,,,,
8.33.011,ONERI E COMMISSIONI BANCARIE ,02/12/2021,150,DARE , ,02/12/2021, ,17.43,1635.049999999999,102024 BANCA DELLA CAMPAN,,,,,
8.33.011,ONERI E COMMISSIONI BANCARIE ,02/12/2021,150,STORNO CRED.MAESE P, ,02/12/2021, ,0.85,1635.899999999999, diversi a diversi,,,,,
8.33.011,ONERI E COMMISSIONI BANCARIE ,03/12/2021,150,DARE , ,03/12/2021, ,2.49,1638.389999999999,102024 BANCA DELLA CAMPAN,,,,,
8.33.011,ONERI E COMMISSIONI BANCARIE ,03/12/2021,150,DARE , ,03/12/2021, ,5.81,1644.199999999999,102024 BANCA DELLA CAMPAN,,,,,
8.33.011,ONERI E COMMISSIONI BANCARIE ,06/12/2021,150,BONIFICO S/FATT. , ,06/12/2021, ,0.83,1645.029999999999, diversi a diversi,,,,,
8.33.011,ONERI E COMMISSIONI BANCARIE ,09/12/2021,150,DARE , ,09/12/2021, ,7.47,1652.499999999999,102024 BANCA DELLA CAMPAN,,,,,
8.33.011,ONERI E COMMISSIONI BANCARIE ,10/12/2021,150,ADDEBITO UTENZE , ,10/12/2021, ,1.1,1653.599999999999, diversi a diversi,,,,,
8.33.011,ONERI E COMMISSIONI BANCARIE ,10/12/2021,150,DARE , ,10/12/2021, ,4.15,1657.749999999999,102024 BANCA DELLA CAMPAN,,,,,
8.33.011,ONERI E COMMISSIONI BANCARIE ,13/12/2021,150,S/FATT.CARTE CRED. , ,13/12/2021, ,30.0,1687.749999999999,208001 FORNITORI C/ANTICI,,,,,
8.33.011,ONERI E COMMISSIONI BANCARIE ,14/12/2021,150,DARE , ,14/12/2021, ,0.83,1688.579999999999,102024 BANCA DELLA CAMPAN,,,,,
8.33.011,ONERI E COMMISSIONI BANCARIE ,16/12/2021,150,DARE , ,16/12/2021, ,0.83,1689.409999999999,102024 BANCA DELLA CAMPAN,,,,,
8.33.011,ONERI E COMMISSIONI BANCARIE ,16/12/2021,150,DARE , ,16/12/2021, ,1.66,1691.069999999999,102024 BANCA DELLA CAMPAN,,,,,
8.33.011,ONERI E COMMISSIONI BANCARIE ,16/12/2021,150,DARE , ,16/12/2021, ,22.0,1713.069999999999,102024 BANCA DELLA CAMPAN,,,,,
8.33.011,ONERI E COMMISSIONI BANCARIE ,17/12/2021,150,ADDEB.RATA MUTUO , ,17/12/2021, ,2.75,1715.819999999999,102024 BANCA DELLA CAMPAN,,,,,
8.33.011,ONERI E COMMISSIONI BANCARIE ,17/12/2021,150,PAGAM.REG.CAMPANIA , ,17/12/2021, ,1.1,1716.919999999999, diversi a diversi,,,,,
8.33.011,ONERI E COMMISSIONI BANCARIE ,20/12/2021,150,DARE , ,20/12/2021, ,2.49,1719.409999999999,102024 BANCA DELLA CAMPAN,,,,,
8.33.011,ONERI E COMMISSIONI BANCARIE ,21/12/2021,150,DARE , ,21/12/2021, ,2.49,1721.899999999999,102024 BANCA DELLA CAMPAN,,,,,
8.33.011,ONERI E COMMISSIONI BANCARIE ,22/12/2021,150,RIMB.SPESE GUARINO , ,22/12/2021, ,0.83,1722.729999999999, diversi a diversi,,,,,
8.33.011,ONERI E COMMISSIONI BANCARIE ,23/12/2021,150,RIMB.TRASF.MAZZEO , ,23/12/2021, ,0.83,1723.559999999999, diversi a diversi,,,,,
8.33.011,ONERI E COMMISSIONI BANCARIE ,27/12/2021,150,DARE , ,27/12/2021, ,1.66,1725.219999999999,102024 BANCA DELLA CAMPAN,,,,,
8.33.011,ONERI E COMMISSIONI BANCARIE ,28/12/2021,150,DARE , ,28/12/2021, ,2.49,1727.709999999999,102024 BANCA DELLA CAMPAN,,,,,
8.33.011,ONERI E COMMISSIONI BANCARIE ,29/12/2021,150,ADDEB.UTENZE , ,29/12/2021, ,1.1,1728.809999999999, diversi a diversi,,,,,
8.33.011,ONERI E COMMISSIONI BANCARIE ,30/12/2021,150,DARE , ,30/12/2021, ,2.49,1731.299999999999,102024 BANCA DELLA CAMPAN,,,,,
8.33.011,ONERI E COMMISSIONI BANCARIE ,31/12/2021,150,DARE , ,31/12/2021, ,24.07,1755.369999999999,102024 BANCA DELLA CAMPAN,,,,,
8.33.011,ONERI E COMMISSIONI BANCARIE ,31/12/2021,150,COMPET.BANC.2021 , ,31/12/2021, ,228.68,1984.049999999999,512001 RATEI PASSIVI,,,,,
8.36.001,PERDITE SU CREDITI ,13/11/2021,150,ISCR.IEEE CARTA CRE, ,12/11/2021, ,0.11,0.11,102024 BANCA DELLA CAMPAN,,,,,
8.36.002,PERDITE SU CAMBI ,13/01/2021,150,C/FATT.BONIFICO , ,13/01/2021, ,183.98,183.98, diversi a diversi,,,,,
8.36.002,PERDITE SU CAMBI ,19/05/2021,150,BONIFICO S/FATT. , ,19/05/2021, ,9.56,193.54, diversi a diversi,,,,,
8.36.002,PERDITE SU CAMBI ,15/07/2021,150,S/FATT.CARTA CRED. , ,15/07/2021, ,36.2,229.74,102024 BANCA DELLA CAMPAN,,,,,
8.36.002,PERDITE SU CAMBI ,14/08/2021,150,PAG.ANAC CARTA CRED, ,14/08/2021, ,0.13,229.87,102024 BANCA DELLA CAMPAN,,,,,
8.36.002,PERDITE SU CAMBI ,14/09/2021,150,S/FATT.ADDEB-CARTA , ,14/09/2021, ,0.12,229.99,102024 BANCA DELLA CAMPAN,,,,,
8.36.002,PERDITE SU CAMBI ,06/10/2021,150,BONIFICO S/FATT. , ,06/10/2021, ,27.95,257.94,102024 BANCA DELLA CAMPAN,,,,,
8.36.002,PERDITE SU CAMBI ,15/10/2021,150,S/FATT.ADDEB.CARTA , ,15/10/2021, ,0.13,258.07,102024 BANCA DELLA CAMPAN,,,,,
8.36.002,PERDITE SU CAMBI ,02/12/2021,150,STORNO CRED.MAESE P, ,02/12/2021, ,0.46,258.53, diversi a diversi,,,,,
8.36.002,PERDITE SU CAMBI ,13/12/2021,150,STORNO PAGAM.CARTA , ,13/12/2021, ,0.12,258.65,208001 FORNITORI C/ANTICI,,,,,
8.36.004,ARROTONDAMENTI PASSIVI ,31/01/2021,150,COMPENSI ALFA GENNA, ,31/01/2021, ,0.87,0.87, diversi a diversi,,,,,
8.36.004,ARROTONDAMENTI PASSIVI ,31/01/2021,150,RETRIBUZ.KAPPA GENN, ,31/01/2021, ,0.18,1.05, diversi a diversi,,,,,
8.36.004,ARROTONDAMENTI PASSIVI ,31/01/2021,150,RETRIBUZ.IOTA GENNA, ,31/01/2021, ,0.28,1.33, diversi a diversi,,,,,
8.36.004,ARROTONDAMENTI PASSIVI ,31/01/2021,150,RETRIBUZ.LAMBDA GEN, ,31/01/2021, ,1.32,2.65, diversi a diversi,,,,,
8.36.004,ARROTONDAMENTI PASSIVI ,16/02/2021,150,ADDEB.RITEN.GENNAIO, ,16/02/2021, ,0.28,2.930000000000001, diversi a diversi,,,,,
8.36.004,ARROTONDAMENTI PASSIVI ,28/02/2021,150,RETRIBUZ.ALFA FEBBR, ,28/02/2021, ,0.31,3.240000000000001, diversi a diversi,,,,,
8.36.004,ARROTONDAMENTI PASSIVI ,28/02/2021,150,"RETRIBUZ,OMEGA FEBB", ,28/02/2021, ,0.45,3.690000000000001, diversi a diversi,,,,,
8.36.004,ARROTONDAMENTI PASSIVI ,28/02/2021,150,RETRIBUZ.ZETA , ,28/02/2021, ,0.16,3.850000000000001, diversi a diversi,,,,,
8.36.004,ARROTONDAMENTI PASSIVI ,28/02/2021,150,RERIBUZ.LAMBDA FEBB, ,28/02/2021, ,0.59,4.440000000000001, diversi a diversi,,,,,
8.36.004,ARROTONDAMENTI PASSIVI ,28/02/2021,150,RETRIBUZ.KAPPA FEBB, ,28/02/2021, ,0.94,5.380000000000001, diversi a diversi,,,,,
8.36.004,ARROTONDAMENTI PASSIVI ,28/02/2021,150,RETRIBUZIONI TAU FE, ,28/02/2021, ,0.96,6.340000000000001, diversi a diversi,,,,,
8.36.004,ARROTONDAMENTI PASSIVI ,28/02/2021,150,RETRIBUZ.IOTA FEBBR, ,28/02/2021, ,0.29,6.630000000000001, diversi a diversi,,,,,
8.36.004,ARROTONDAMENTI PASSIVI ,28/02/2021,150,"RETRIBUZ,BETA FEBBR", ,28/02/2021, ,2.28,8.91, diversi a diversi,,,,,
8.36.004,ARROTONDAMENTI PASSIVI ,16/03/2021,150,DARE , ,16/03/2021, ,0.84,9.75, diversi a diversi,,,,,
8.36.004,ARROTONDAMENTI PASSIVI ,31/03/2021,199,ACQUISTI REVERSE CH,182985,24/03/2021,94,0.02,9.77,AMAEU Amazon EU S.a r.l.,,,,,
8.36.004,ARROTONDAMENTI PASSIVI ,31/03/2021,150,RETRIBUZ.ALFA MARZO, ,31/03/2021, ,0.18,9.95, diversi a diversi,,,,,
8.36.004,ARROTONDAMENTI PASSIVI ,31/03/2021,150,RETRIBUZ.OMEGA MARZ, ,31/03/2021, ,0.61,10.56, diversi a diversi,,,,,
8.36.004,ARROTONDAMENTI PASSIVI ,31/03/2021,150,RETRIBUZ.ZETA MARZO, ,31/03/2021, ,1.81,12.37, diversi a diversi,,,,,
8.36.004,ARROTONDAMENTI PASSIVI ,31/03/2021,150,RETRIBUZ.LAMBDA MAR, ,31/03/2021, ,0.47,12.84, diversi a diversi,,,,,
8.36.004,ARROTONDAMENTI PASSIVI ,31/03/2021,150,"RETRIBUZ,KAPPA MARZ", ,31/03/2021, ,0.66,13.5, diversi a diversi,,,,,
8.36.004,ARROTONDAMENTI PASSIVI ,31/03/2021,150,RETRIBUZ.TAU MARZO , ,31/03/2021, ,0.59,14.09, diversi a diversi,,,,,
8.36.004,ARROTONDAMENTI PASSIVI ,30/04/2021,150,RETRIBUZ.ALFA APRIL, ,30/04/2021, ,0.18,14.27, diversi a diversi,,,,,
8.36.004,ARROTONDAMENTI PASSIVI ,30/04/2021,150,RETRIBUZ.BETA APRIL, ,30/04/2021, ,1.02,15.29, diversi a diversi,,,,,
8.36.004,ARROTONDAMENTI PASSIVI ,30/04/2021,150,RETRIBUZIONI ZETA A, ,30/04/2021, ,1.25,16.54, diversi a diversi,,,,,
8.36.004,ARROTONDAMENTI PASSIVI ,30/04/2021,150,RETRIBUZ.THETA APRI, ,30/04/2021, ,0.23,16.77, diversi a diversi,,,,,
8.36.004,ARROTONDAMENTI PASSIVI ,30/04/2021,150,RETRIBUZ.LAMBDA APR, ,30/04/2021, ,0.32,17.09, diversi a diversi,,,,,
8.36.004,ARROTONDAMENTI PASSIVI ,30/04/2021,150,RETRIBUZ.TAU APRILE, ,30/04/2021, ,0.36,17.45, diversi a diversi,,,,,
8.36.004,ARROTONDAMENTI PASSIVI ,30/04/2021,150,RETRIBUZ.IOTA APRIL, ,30/04/2021, ,0.49,17.94, diversi a diversi,,,,,
8.36.004,ARROTONDAMENTI PASSIVI ,31/05/2021,150,RETRIBUZ.ZETA MAGGI, ,31/05/2021, ,0.5,18.44, diversi a diversi,,,,,
8.36.004,ARROTONDAMENTI PASSIVI ,31/05/2021,150,RETRIBUZ.KAPPA MAGG, ,31/05/2021, ,0.02,18.46, diversi a diversi,,,,,
8.36.004,ARROTONDAMENTI PASSIVI ,31/05/2021,150,RETRIBUZ.TAU MAGGIO, ,31/05/2021, ,0.71,19.17, diversi a diversi,,,,,
8.36.004,ARROTONDAMENTI PASSIVI ,31/05/2021,150,RETRIBUZ.IOTA MAGGI, ,31/05/2021, ,0.42,19.59, diversi a diversi,,,,,
8.36.004,ARROTONDAMENTI PASSIVI ,31/05/2021,150,RETRIBUZ.ETA MAGGIO, ,31/05/2021, ,0.05,19.64, diversi a diversi,,,,,
8.36.004,ARROTONDAMENTI PASSIVI ,30/06/2021,150,RETRIBUZ.ALFA GIUGN, ,30/06/2021, ,0.78,20.42, diversi a diversi,,,,,
8.36.004,ARROTONDAMENTI PASSIVI ,30/06/2021,150,RETRIBUZ.OMEGA GIUG, ,30/06/2021, ,1.14,21.56, diversi a diversi,,,,,
8.36.004,ARROTONDAMENTI PASSIVI ,30/06/2021,150,RETRIBUZ.ZETA GIUGN, ,30/06/2021, ,0.47,22.03, diversi a diversi,,,,,
8.36.004,ARROTONDAMENTI PASSIVI ,30/06/2021,150,"RETRIBUZ,LAMBDA GIU", ,30/06/2021, ,1.28,23.31, diversi a diversi,,,,,
8.36.004,ARROTONDAMENTI PASSIVI ,30/06/2021,150,RETRIBUZ.KAPPA GIUG, ,30/06/2021, ,0.46,23.77, diversi a diversi,,,,,
8.36.004,ARROTONDAMENTI PASSIVI ,30/06/2021,150,RETRIBUZ.TAU GIUGNO, ,30/06/2021, ,0.05,23.82, diversi a diversi,,,,,
8.36.004,ARROTONDAMENTI PASSIVI ,30/06/2021,150,RETRIBUZ.ETA GIUGNO, ,30/06/2021, ,0.71,24.53, diversi a diversi,,,,,
8.36.004,ARROTONDAMENTI PASSIVI ,16/07/2021,150,ADDEB.RITEN.GIUGNO , ,16/07/2021, ,0.14,24.67000000000001, diversi a diversi,,,,,
8.36.004,ARROTONDAMENTI PASSIVI ,31/07/2021,150,"RETRIBUZ,ALFA LUGLI", ,31/07/2021, ,0.1,24.77000000000001, diversi a diversi,,,,,
8.36.004,ARROTONDAMENTI PASSIVI ,31/07/2021,150,RETRIBUZ.OMEGA LUGL, ,31/07/2021, ,0.63,25.40000000000001, diversi a diversi,,,,,
8.36.004,ARROTONDAMENTI PASSIVI ,31/07/2021,150,RETRIBUZ.KAPPA LUGL, ,31/07/2021, ,0.31,25.71, diversi a diversi,,,,,
8.36.004,ARROTONDAMENTI PASSIVI ,31/07/2021,150,RETRIBUZ.IOTA LUGLI, ,31/07/2021, ,0.67,26.38000000000001, diversi a diversi,,,,,
8.36.004,ARROTONDAMENTI PASSIVI ,31/07/2021,150,RETRIB.ETA LUGLIO , ,31/07/2021, ,0.56,26.94, diversi a diversi,,,,,
8.36.004,ARROTONDAMENTI PASSIVI ,31/07/2021,150,RETRIBUZ.BETA LUGLI, ,31/07/2021, ,0.7,27.64, diversi a diversi,,,,,
8.36.004,ARROTONDAMENTI PASSIVI ,20/08/2021,150,DARE , ,20/08/2021, ,0.2,27.84, diversi a diversi,,,,,
8.36.004,ARROTONDAMENTI PASSIVI ,31/08/2021,150,RETRIBUZIONI ALFA A, ,31/08/2021, ,0.7,28.54, diversi a diversi,,,,,
8.36.004,ARROTONDAMENTI PASSIVI ,31/08/2021,150,RETRIBUZ.ZETA AGOST, ,31/08/2021, ,0.47,29.01, diversi a diversi,,,,,
8.36.004,ARROTONDAMENTI PASSIVI ,31/08/2021,150,RETRIBUZ.THETA AGOS, ,31/08/2021, ,0.03,29.04, diversi a diversi,,,,,
8.36.004,ARROTONDAMENTI PASSIVI ,31/08/2021,150,RETRIBUZ.LAMBDA AGO, ,31/08/2021, ,1.51,30.55, diversi a diversi,,,,,
8.36.004,ARROTONDAMENTI PASSIVI ,31/08/2021,150,RETRIBUZ.KAPPA AGOS, ,31/08/2021, ,0.39,30.94, diversi a diversi,,,,,
8.36.004,ARROTONDAMENTI PASSIVI ,30/09/2021,150,RETRIBUZ.ALFA SETTE, ,30/09/2021, ,0.69,31.63000000000001, diversi a diversi,,,,,
8.36.004,ARROTONDAMENTI PASSIVI ,30/09/2021,150,RETRIBUZ.KAPPA SETT, ,30/09/2021, ,1.01,32.64000000000001, diversi a diversi,,,,,
8.36.004,ARROTONDAMENTI PASSIVI ,30/09/2021,150,RETRIBUZ.IOTA SETTE, ,30/09/2021, ,0.21,32.85000000000001, diversi a diversi,,,,,
8.36.004,ARROTONDAMENTI PASSIVI ,30/09/2021,150,RETRIB.ETA SETTEMBR, ,30/09/2021, ,0.76,33.61000000000001, diversi a diversi,,,,,
8.36.004,ARROTONDAMENTI PASSIVI ,06/10/2021,150,BONIFICO S/FATT. , ,06/10/2021, ,0.01,33.62,102024 BANCA DELLA CAMPAN,,,,,
8.36.004,ARROTONDAMENTI PASSIVI ,18/10/2021,150,ADDEB.RITEN.SETTEMB, ,18/10/2021, ,0.6,34.22000000000001, diversi a diversi,,,,,
8.36.004,ARROTONDAMENTI PASSIVI ,31/10/2021,150,RETRIB.ALFA OTTOBRE, ,31/10/2021, ,0.09,34.31000000000001, diversi a diversi,,,,,
8.36.004,ARROTONDAMENTI PASSIVI ,31/10/2021,150,RETRIBUZ.OMEGA OTTO, ,31/10/2021, ,0.02,34.33000000000001, diversi a diversi,,,,,
8.36.004,ARROTONDAMENTI PASSIVI ,31/10/2021,150,RETRIBUZ.ZETA OTTOB, ,31/10/2021, ,0.25,34.58000000000001, diversi a diversi,,,,,
8.36.004,ARROTONDAMENTI PASSIVI ,31/10/2021,150,RETRIBUZ.LAMBDA OTT, ,31/10/2021, ,0.17,34.75000000000001, diversi a diversi,,,,,
8.36.004,ARROTONDAMENTI PASSIVI ,31/10/2021,150,RETRIBUZ.KAPPA OTTO, ,31/10/2021, ,0.08,34.83000000000001, diversi a diversi,,,,,
8.36.004,ARROTONDAMENTI PASSIVI ,31/10/2021,150,RETRIBUZ.THETA OTTO, ,31/10/2021, ,4.61,39.44000000000001, diversi a diversi,,,,,
8.36.004,ARROTONDAMENTI PASSIVI ,30/11/2021,150,RETRIBUZIONI NOVEMB, ,30/11/2021, ,1.03,40.47000000000001, diversi a diversi,,,,,
8.36.004,ARROTONDAMENTI PASSIVI ,30/11/2021,150,RETRIB.BETA NOVEMBR, ,30/11/2021, ,2.18,42.65000000000001, diversi a diversi,,,,,
8.36.004,ARROTONDAMENTI PASSIVI ,30/11/2021,150,RETRIBUZ.OMEGA NOVE, ,30/11/2021, ,0.09,42.74000000000002, diversi a diversi,,,,,
8.36.004,ARROTONDAMENTI PASSIVI ,30/11/2021,150,"RETRIB,LAMBDA NOVEM", ,30/11/2021, ,0.81,43.55000000000002, diversi a diversi,,,,,
8.36.004,ARROTONDAMENTI PASSIVI ,30/11/2021,150,RETRIBUZ.KAPPA NOVE, ,30/11/2021, ,0.54,44.09000000000002, diversi a diversi,,,,,
8.36.004,ARROTONDAMENTI PASSIVI ,30/11/2021,150,RETRIBUB.ZETA NOVEM, ,30/11/2021, ,0.75,44.84000000000002, diversi a diversi,,,,,
8.36.004,ARROTONDAMENTI PASSIVI ,31/12/2021,150,RETRIBUZ.C10 , ,31/12/2021, ,0.69,45.53000000000002, diversi a diversi,,,,,
8.36.004,ARROTONDAMENTI PASSIVI ,31/12/2021,150,RETRIBUZ.OMEGA DICE, ,31/12/2021, ,0.99,46.52000000000002, diversi a diversi,,,,,
8.36.004,ARROTONDAMENTI PASSIVI ,31/12/2021,150,RETRIB.LAMBDA DICEM, ,31/12/2021, ,0.02,46.54000000000002, diversi a diversi,,,,,
8.36.004,ARROTONDAMENTI PASSIVI ,31/12/2021,150,RETRIB.IOTA DICEMBR, ,31/12/2021, ,0.01,46.55000000000002, diversi a diversi,,,,,
8.36.004,ARROTONDAMENTI PASSIVI ,31/12/2021,150,RETRIBUZ.RHO DICEMB, ,31/12/2021, ,0.82,47.37000000000002, diversi a diversi,,,,,
8.37.010,DIRITTI CAMERALI ,03/03/2021,150,SPESE X VIDIMAZ.FOR, ,22/02/2021, ,25.0,25.0,101001 CASSA CONTANTI,,,,,
8.37.010,DIRITTI CAMERALI ,15/09/2021,150,I RATA ACC.IMPOSTE , ,15/09/2021, ,524.0,549.0, diversi a diversi,,,,,
8.37.013,IMPOSTE IRES ,31/12/2021,150,IRES DI COMPETENZA , ,31/12/2021, ,11518.0,11518.0, diversi a diversi,,,,,
8.37.014,IMPOSTE IRAP ,31/12/2021,150,IRAP DI COMPETENZA , ,31/12/2021, ,3082.0,3082.0, diversi a diversi,,,,,
8.38.003,IMPOSTA DI REGISTRO ,02/01/2021,150,GIROCONTO , ,02/01/2021, ,15103.23,15103.23,323001 RISCONTI ATTIVI,,,,,
8.38.003,IMPOSTA DI REGISTRO ,07/06/2021,150,"IMP.REG.CONTR,SEREN", ,07/06/2021, ,447.0,15550.23,102024 BANCA DELLA CAMPAN,,,,,
8.38.003,IMPOSTA DI REGISTRO ,25/10/2021,150,IMP.REG.2021 , ,25/10/2021, ,200.0,15750.23,102024 BANCA DELLA CAMPAN,,,,,
8.38.003,IMPOSTA DI REGISTRO ,25/10/2021,150,PROROGA CONTR.LOCAZ, ,25/10/2021, ,149.0,15899.23,102024 BANCA DELLA CAMPAN,,,,,
8.38.003,IMPOSTA DI REGISTRO ,25/10/2021,150,PROROGA+ANN.2021 , ,25/10/2021, ,80.0,15979.23,102024 BANCA DELLA CAMPAN,,,,,
8.38.003,IMPOSTA DI REGISTRO ,31/12/2021,160,IMP.REG+BOLLI REGIS, ,31/12/2021, ,-13343.62,2635.609999999999,323001 RISCONTI ATTIVI,,,,,
8.38.004,IMPOSTA DI BOLLO ,14/01/2021,150,S/FATT.ADDEB.CARTA , ,14/01/2021, ,2.0,2.0,102024 BANCA DELLA CAMPAN,,,,,
8.38.004,IMPOSTA DI BOLLO ,04/02/2021,150,DARE , ,31/01/2021, ,8.33,10.33,102024 BANCA DELLA CAMPAN,,,,,
8.38.004,IMPOSTA DI BOLLO ,28/02/2021,100,FATTURA DI ACQUISTO,4/E ,24/02/2021,33,2.0,12.33,MDMELE MDM ELETTRONICA DI,,,,,
8.38.004,IMPOSTA DI BOLLO ,04/03/2021,150,DARE , ,28/02/2021, ,8.33,20.66,102024 BANCA DELLA CAMPAN,,,,,
8.38.004,IMPOSTA DI BOLLO ,13/03/2021,150,S/FATT.ADDEB.CARTA , ,13/03/2021, ,2.0,22.66,102024 BANCA DELLA CAMPAN,,,,,
8.38.004,IMPOSTA DI BOLLO ,01/04/2021,150,DARE , ,31/03/2021, ,24.66,47.32,102038 UNICREDIT BANCA,,,,,
8.38.004,IMPOSTA DI BOLLO ,09/04/2021,150,DARE , ,31/03/2021, ,8.33,55.65,102024 BANCA DELLA CAMPAN,,,,,
8.38.004,IMPOSTA DI BOLLO ,07/05/2021,150,DARE , ,30/04/2021, ,8.33,63.98,102024 BANCA DELLA CAMPAN,,,,,
8.38.004,IMPOSTA DI BOLLO ,07/06/2021,150,DARE , ,31/05/2021, ,8.33,72.31,102024 BANCA DELLA CAMPAN,,,,,
8.38.004,IMPOSTA DI BOLLO ,01/07/2021,150,DARE , ,30/06/2021, ,24.93,97.24000000000001,102038 UNICREDIT BANCA,,,,,
8.38.004,IMPOSTA DI BOLLO ,06/07/2021,150,DARE , ,30/06/2021, ,8.33,105.57,102024 BANCA DELLA CAMPAN,,,,,
8.38.004,IMPOSTA DI BOLLO ,15/07/2021,150,"BOLLO SU FATT, ", ,15/07/2021, ,2.0,107.57,102024 BANCA DELLA CAMPAN,,,,,
8.38.004,IMPOSTA DI BOLLO ,15/07/2021,150,S/FATT.CARTA CRED. , ,15/07/2021, ,2.0,109.57,102024 BANCA DELLA CAMPAN,,,,,
8.38.004,IMPOSTA DI BOLLO ,05/08/2021,150,DARE , ,31/07/2021, ,8.33,117.9,102024 BANCA DELLA CAMPAN,,,,,
8.38.004,IMPOSTA DI BOLLO ,14/08/2021,150,PAG.ANAC CARTA CRED, ,14/08/2021, ,2.0,119.9,102024 BANCA DELLA CAMPAN,,,,,
8.38.004,IMPOSTA DI BOLLO ,07/09/2021,150,DARE , ,31/08/2021, ,8.33,128.23,102024 BANCA DELLA CAMPAN,,,,,
8.38.004,IMPOSTA DI BOLLO ,01/10/2021,150,DARE , ,30/09/2021, ,25.2,153.43,102038 UNICREDIT BANCA,,,,,
8.38.004,IMPOSTA DI BOLLO ,07/10/2021,150,DARE , ,30/09/2021, ,8.33,161.76,102024 BANCA DELLA CAMPAN,,,,,
8.38.004,IMPOSTA DI BOLLO ,15/10/2021,150,S/FATT.ADDEB.CARTA , ,15/10/2021, ,2.0,163.76,102024 BANCA DELLA CAMPAN,,,,,
8.38.004,IMPOSTA DI BOLLO ,05/11/2021,150,DARE , ,31/10/2021, ,8.33,172.09,102024 BANCA DELLA CAMPAN,,,,,
8.38.004,IMPOSTA DI BOLLO ,13/11/2021,150,ISCR.IEEE CARTA CRE, ,12/11/2021, ,2.0,174.09,102024 BANCA DELLA CAMPAN,,,,,
8.38.004,IMPOSTA DI BOLLO ,19/11/2021,150,BOLLO SU FATT. , ,19/11/2021, ,2.0,176.09,102024 BANCA DELLA CAMPAN,,,,,
8.38.004,IMPOSTA DI BOLLO ,02/12/2021,150,STORNO CRED.MAESE P, ,02/12/2021, ,2.0,178.09, diversi a diversi,,,,,
8.38.004,IMPOSTA DI BOLLO ,07/12/2021,150,DARE , ,30/11/2021, ,8.33,186.42,102024 BANCA DELLA CAMPAN,,,,,
8.38.005,TASSE DI CONCESSIONI GOVERNATIVE ,16/03/2021,150,"ADDEB,TASSA VIDIMAZ", ,16/03/2021, ,309.87,309.87,102024 BANCA DELLA CAMPAN,,,,,
8.38.012,DIRITTI DOGANALI ,30/06/2021,106,BOLLETTA DOGANALE ,51369,30/06/2021,208,78.37,78.37,510005 SPEDIZIONIERI C/SP,,,,,
8.38.012,DIRITTI DOGANALI ,30/11/2021,106,BOLLETTA DOGANALE ,357458,24/11/2021,419,23.57,101.94,510005 SPEDIZIONIERI C/SP,,,,,
8.46.005,ONERI ED INTERESSI VARI ,16/03/2021,150,RAVVED.RITEN.12/202, ,16/03/2021, ,16.71,16.71,102024 BANCA DELLA CAMPAN,,,,,
8.46.005,ONERI ED INTERESSI VARI ,30/07/2021,150,"PAG.RITEN,12/2020 ", ,30/07/2021, ,75.11,91.82,102024 BANCA DELLA CAMPAN,,,,,
8.46.005,ONERI ED INTERESSI VARI ,15/09/2021,150,I RATA ACC.IMPOSTE , ,15/09/2021, ,33.0,124.82, diversi a diversi,,,,,
8.46.005,ONERI ED INTERESSI VARI ,15/09/2021,150,I RATA ACC.IMPOSTE , ,15/09/2021, ,4.5,129.32, diversi a diversi,,,,,
8.46.005,ONERI ED INTERESSI VARI ,18/10/2021,150,III RATA IMPOSTE , ,18/10/2021, ,8.56,137.88,102024 BANCA DELLA CAMPAN,,,,,
8.46.005,ONERI ED INTERESSI VARI ,25/10/2021,150,AVV.ACCERT.IMP.REG., ,25/10/2021, ,74.75,212.63,102024 BANCA DELLA CAMPAN,,,,,
8.46.005,ONERI ED INTERESSI VARI ,25/10/2021,150,IMP.REG.2021 , ,25/10/2021, ,7.51,220.14,102024 BANCA DELLA CAMPAN,,,,,
8.46.005,ONERI ED INTERESSI VARI ,25/10/2021,150,PROROGA CONTR.LOCAZ, ,25/10/2021, ,6.45,226.59,102024 BANCA DELLA CAMPAN,,,,,
8.46.005,ONERI ED INTERESSI VARI ,25/10/2021,150,PROROGA+ANN.2021 , ,25/10/2021, ,3.0,229.59,102024 BANCA DELLA CAMPAN,,,,,
8.46.005,ONERI ED INTERESSI VARI ,10/11/2021,150,ADDEB.AVV.BON.770/2, ,10/11/2021, ,34.03,263.62,102024 BANCA DELLA CAMPAN,,,,,
8.46.005,ONERI ED INTERESSI VARI ,16/11/2021,150,IV RATA IMPOSTE , ,16/11/2021, ,16.27,279.89,102024 BANCA DELLA CAMPAN,,,,,
8.46.005,ONERI ED INTERESSI VARI ,16/12/2021,150,PAG.IVA NOVEMBRE , ,16/12/2021, ,11.11,291.0,102024 BANCA DELLA CAMPAN,,,,,
8.46.007,SANZIONI ,29/04/2021,150,SANZ.X TARDIV. , ,29/04/2021, ,36.0,36.0,216003 ERARIO C/IVA,,,,,
8.46.008,COSTI NON INERENTI ,31/01/2021,199,ACQUISTI REVERSE CH,67582,21/01/2021,12,118.36,118.36,VODAFO VODAFONE ITALIA S.,,,,,
8.46.008,COSTI NON INERENTI ,28/02/2021,199,ACQUISTI REVERSE CH,63902,01/02/2021,41,11.16,129.52,LINKEM LINKEM S.P.A.,,,,,
8.46.008,COSTI NON INERENTI ,09/03/2021,150,RIMB.SPESE IRACE , ,09/03/2021, ,3529.73,3659.25,102024 BANCA DELLA CAMPAN,,,,,
8.46.008,COSTI NON INERENTI ,31/03/2021,199,ACQUISTI REVERSE CH,91042,20/03/2021,91,113.59,3772.84,VODAFO VODAFONE ITALIA S.,,,,,
8.46.008,COSTI NON INERENTI ,30/04/2021,199,ACQUISTI REVERSE CH,36173,03/04/2021,108,10.88,3783.72,LINKEM LINKEM S.P.A.,,,,,
8.46.008,COSTI NON INERENTI ,31/05/2021,199,ACQUISTI REVERSE CH,907815,20/05/2021,163,127.83,3911.55,VODAFO VODAFONE ITALIA S.,,,,,
8.46.008,COSTI NON INERENTI ,30/06/2021,199,ACQUISTI REVERSE CH,1212021,31/05/2021,178,9.96,3921.51,LINKEM LINKEM S.P.A.,,,,,
8.46.008,COSTI NON INERENTI ,31/07/2021,199,ACQUISTI REVERSE CH,51125,22/07/2021,253,118.52,4040.03,VODAFO VODAFONE ITALIA S.,,,,,
8.46.008,COSTI NON INERENTI ,31/08/2021,199,ACQUISTI REVERSE CH,23833,01/08/2021,272,9.96,4049.99,LINKEM LINKEM S.P.A.,,,,,
8.46.008,COSTI NON INERENTI ,30/09/2021,199,ACQUISTI REVERSE CH,88667,22/09/2021,292,114.51,4164.5,VODAFO VODAFONE ITALIA S.,,,,,
8.46.008,COSTI NON INERENTI ,31/10/2021,199,ACQUISTI REVERSE CH,40960,29/09/2021,326,9.96,4174.46,LINKEM LINKEM S.P.A.,,,,,
8.46.008,COSTI NON INERENTI ,30/11/2021,199,ACQUISTI REVERSE CH,60385,20/11/2021,413,161.14,4335.6,VODAFO VODAFONE ITALIA S.,,,,,
8.46.009,COSTI NON DI COMPETENZA ,04/01/2021,150,SPESE BANCARIE 2020, ,01/01/2021, ,17.92,17.92,102038 UNICREDIT BANCA,,,,,
8.46.009,COSTI NON DI COMPETENZA ,04/01/2021,150,SPESE BANC.2020 , ,31/12/2020, ,25.14,43.06,102038 UNICREDIT BANCA,,,,,
8.46.009,COSTI NON DI COMPETENZA ,08/12/2021,150,COMPET.BANC.2020 , ,31/12/2020, ,8.33,51.39,102024 BANCA DELLA CAMPAN,,,,,
8.46.009,COSTI NON DI COMPETENZA ,14/01/2021,150,COMPET.2021 , ,14/01/2021, ,271.52,322.91,846009 COSTI NON DI COMPE,,,,,
8.46.009,COSTI NON DI COMPETENZA ,14/01/2021,160,COMPET.2021 , ,14/01/2021, ,-60.91,262.0,846009 COSTI NON DI COMPE,,,,,
8.46.009,COSTI NON DI COMPETENZA ,25/10/2021,150,AVV.ACCERT.IMP.REG., ,25/10/2021, ,200.0,462.0,102024 BANCA DELLA CAMPAN,,,,,
8.46.009,COSTI NON DI COMPETENZA ,31/10/2021,150,MESE DICEMBRE 2020 , ,31/10/2021, ,904.17,1366.17,812000 LOCAZIONI,,,,,
9.01.001,MERCI C/VENDITE ,31/03/2021,229,CESS.COMPENS.REV.CH,222,08/03/2021,64,-45.0,45.0,DELLIC GRAFICHE IUORIO S.,,,,,
9.01.001,MERCI C/VENDITE ,31/03/2021,150,Giroconto Cessione ,222,08/03/2021, ,45.0,0.0,DELLIC GRAFICHE IUORIO S.,,,,,
9.01.001,MERCI C/VENDITE ,30/04/2021,229,CESS.COMPENS.REV.CH,105/M ,21/04/2021,105,-234.0,234.0,MORRET MORRETTA FRANCESCO,,,,,
9.01.001,MERCI C/VENDITE ,30/04/2021,150,Giroconto Cessione ,105/M ,21/04/2021, ,234.0,0.0,MORRET MORRETTA FRANCESCO,,,,,
9.01.001,MERCI C/VENDITE ,30/06/2021,229,CESS.COMPENS.REV.CH,30712,19/05/2021,146,-5.31,5.31,POSITA POSTE ITALIANE SPA,,,,,
9.01.001,MERCI C/VENDITE ,30/06/2021,150,Giroconto Cessione ,30712,19/05/2021, ,5.31,0.0,POSITA POSTE ITALIANE SPA,,,,,
9.01.001,MERCI C/VENDITE ,30/11/2021,150,Giroconto Cessione ,35843,23/11/2021, ,3.7,-3.7,POSITA POSTE ITALIANE SPA,,,,,
9.01.001,MERCI C/VENDITE ,30/11/2021,229,CESS.COMPENS.REV.CH,35843,23/11/2021,337,-3.7,0.0,POSITA POSTE ITALIANE SPA,,,,,
9.01.017,RICAVI C/VENDITE ,31/01/2021,229,CESS.COMPENS.REV.CH,6/PA ,31/12/2020,1,-500.0,500.0,TRUSTE TRUSTECH S.R.L.,,,,,
9.01.017,RICAVI C/VENDITE ,31/01/2021,150,Giroconto Cessione ,6/PA ,31/12/2020, ,500.0,0.0,TRUSTE TRUSTECH S.R.L.,,,,,
9.01.017,RICAVI C/VENDITE ,31/01/2021,229,CESS.COMPENS.REV.CH,5/PA ,31/12/2020,2,-3000.0,3000.0,TRUSTE TRUSTECH S.R.L.,,,,,
9.01.017,RICAVI C/VENDITE ,31/01/2021,150,Giroconto Cessione ,5/PA ,31/12/2020, ,3000.0,0.0,TRUSTE TRUSTECH S.R.L.,,,,,
9.01.017,RICAVI C/VENDITE ,31/01/2021,229,CESS.COMPENS.REV.CH,FPR419 ,31/12/2020,3,-250.0,250.0,NUOQUA NUOVA QUADRIFOGLIO,,,,,
9.01.017,RICAVI C/VENDITE ,31/01/2021,150,Giroconto Cessione ,FPR419 ,31/12/2020, ,250.0,0.0,NUOQUA NUOVA QUADRIFOGLIO,,,,,
9.01.017,RICAVI C/VENDITE ,31/01/2021,229,CESS.COMPENS.REV.CH,3,07/01/2021,4,-950.0,950.0,NOTGER NOTARBARTOLO & GER,,,,,
9.01.017,RICAVI C/VENDITE ,31/01/2021,150,Giroconto Cessione ,3,07/01/2021, ,0.0,0.0,NOTGER NOTARBARTOLO & GER,,,,,
9.01.017,RICAVI C/VENDITE ,31/01/2021,229,CESS.COMPENS.REV.CH,44256,07/01/2021,5,-5601.05,5601.05,DBELE DB ELECTRONIC INST,,,,,
9.01.017,RICAVI C/VENDITE ,31/01/2021,150,Giroconto Cessione ,44256,07/01/2021, ,5601.05,0.0,DBELE DB ELECTRONIC INST,,,,,
9.01.017,RICAVI C/VENDITE ,31/01/2021,229,CESS.COMPENS.REV.CH,13874,23/12/2020,6,-258.86,258.86,ONLSTO ONLINESTORE S.R.L.,,,,,
9.01.017,RICAVI C/VENDITE ,31/01/2021,150,Giroconto Cessione ,13874,23/12/2020, ,258.86,0.0,ONLSTO ONLINESTORE S.R.L.,,,,,
9.01.017,RICAVI C/VENDITE ,31/01/2021,229,CESS.COMPENS.REV.CH,15431,05/01/2021,7,-13.02,13.02,BANEMI BPER BANCA S.P.A.,,,,,
9.01.017,RICAVI C/VENDITE ,31/01/2021,150,Giroconto Cessione ,15431,05/01/2021, ,13.02,0.0,BANEMI BPER BANCA S.P.A.,,,,,
9.01.017,RICAVI C/VENDITE ,31/01/2021,229,CESS.COMPENS.REV.CH,45068,01/07/2020,8,-24587.0,24587.0,VWR VWR INTERNATIONAL,,,,,
9.01.017,RICAVI C/VENDITE ,31/01/2021,150,Giroconto Cessione ,45068,01/07/2020, ,24587.0,0.0,VWR VWR INTERNATIONAL,,,,,
9.01.017,RICAVI C/VENDITE ,31/01/2021,229,CESS.COMPENS.REV.CH,67582,21/01/2021,9,-591.8,591.8,VODAFO VODAFONE ITALIA S.,,,,,
9.01.017,RICAVI C/VENDITE ,31/01/2021,150,Giroconto Cessione ,67582,21/01/2021, ,591.8,0.0,VODAFO VODAFONE ITALIA S.,,,,,
9.01.017,RICAVI C/VENDITE ,31/01/2021,229,CESS.COMPENS.REV.CH,20-FE ,22/01/2021,10,-4391.0,4391.0,BIOFOT Biofotonica SRL,,,,,
9.01.017,RICAVI C/VENDITE ,31/01/2021,150,Giroconto Cessione ,20-FE ,22/01/2021, ,4391.0,0.0,BIOFOT Biofotonica SRL,,,,,
9.01.017,RICAVI C/VENDITE ,31/01/2021,229,CESS.COMPENS.REV.CH,40,22/01/2021,11,-30.0,30.0,MCSSRL MCS S.R.L.,,,,,
9.01.017,RICAVI C/VENDITE ,31/01/2021,150,Giroconto Cessione ,40,22/01/2021, ,30.0,0.0,MCSSRL MCS S.R.L.,,,,,
9.01.017,RICAVI C/VENDITE ,31/01/2021,229,CESS.COMPENS.REV.CH,49,21/01/2021,12,-28.99,28.99,TECRAI Aruba S.p.A.,,,,,
9.01.017,RICAVI C/VENDITE ,31/01/2021,150,Giroconto Cessione ,49,21/01/2021, ,28.99,0.0,TECRAI Aruba S.p.A.,,,,,
9.01.017,RICAVI C/VENDITE ,31/01/2021,229,CESS.COMPENS.REV.CH,4336,19/01/2021,13,-50.0,50.0,MESSAG MESSAGENET S.R.L.,,,,,
9.01.017,RICAVI C/VENDITE ,31/01/2021,150,Giroconto Cessione ,4336,19/01/2021, ,50.0,0.0,MESSAG MESSAGENET S.R.L.,,,,,
9.01.017,RICAVI C/VENDITE ,31/01/2021,1229,CESS.COMPENS.REV.CH,1/NC ,26/01/2021,14,620.0,-620.0,NOINTE NOVA INFORMATION T,,,,,
9.01.017,RICAVI C/VENDITE ,31/01/2021,160,Giroconto Cessione ,1/NC ,26/01/2021, ,-620.0,0.0,NOINTE NOVA INFORMATION T,,,,,
9.01.017,RICAVI C/VENDITE ,31/01/2021,229,CESS.COMPENS.REV.CH,3,28/01/2021,15,-450.0,450.0,ZIEGLE ZIEGLER EMILIO OFF,,,,,
9.01.017,RICAVI C/VENDITE ,31/01/2021,150,Giroconto Cessione ,3,28/01/2021, ,450.0,0.0,ZIEGLE ZIEGLER EMILIO OFF,,,,,
9.01.017,RICAVI C/VENDITE ,31/01/2021,229,CESS.COMPENS.REV.CH,235,27/01/2021,16,-950.0,950.0,NOTGER NOTARBARTOLO & GER,,,,,
9.01.017,RICAVI C/VENDITE ,31/01/2021,150,Giroconto Cessione ,235,27/01/2021, ,950.0,0.0,NOTGER NOTARBARTOLO & GER,,,,,
9.01.017,RICAVI C/VENDITE ,31/01/2021,229,CESS.COMPENS.REV.CH,11A ,28/01/2021,17,-88000.0,88000.0,MAXFON MAXFON S.R.L.,,,,,
9.01.017,RICAVI C/VENDITE ,31/01/2021,150,Giroconto Cessione ,11A ,28/01/2021, ,88000.0,0.0,MAXFON MAXFON S.R.L.,,,,,
9.01.017,RICAVI C/VENDITE ,31/01/2021,229,CESS.COMPENS.REV.CH,1,28/01/2021,18,-37500.0,37500.0,PAPROG PA PROGETTI SRL,,,,,
9.01.017,RICAVI C/VENDITE ,31/01/2021,150,Giroconto Cessione ,1,28/01/2021, ,37500.0,0.0,PAPROG PA PROGETTI SRL,,,,,
9.01.017,RICAVI C/VENDITE ,31/01/2021,229,CESS.COMPENS.REV.CH,9/PRSP ,19/01/2021,19,-371.0,371.0,SIALSR S.I.A.L. SRL,,,,,
9.01.017,RICAVI C/VENDITE ,31/01/2021,150,Giroconto Cessione ,9/PRSP ,29/01/2021, ,371.0,0.0,SIALSR S.I.A.L. SRL,,,,,
9.01.017,RICAVI C/VENDITE ,31/01/2021,229,CESS.COMPENS.REV.CH,2/SP ,29/01/2021,20,-196.89,196.89,SIDSPA SIDERSAN SPA,,,,,
9.01.017,RICAVI C/VENDITE ,31/01/2021,150,Giroconto Cessione ,2/SP ,29/01/2021, ,196.89,0.0,SIDSPA SIDERSAN SPA,,,,,
9.01.017,RICAVI C/VENDITE ,31/01/2021,229,CESS.COMPENS.REV.CH,4,28/01/2021,21,-26000.0,26000.0,DACINF Dac Informatica Sr,,,,,
9.01.017,RICAVI C/VENDITE ,31/01/2021,150,Giroconto Cessione ,4,28/01/2021, ,26000.0,0.0,DACINF Dac Informatica Sr,,,,,
9.01.017,RICAVI C/VENDITE ,31/01/2021,229,CESS.COMPENS.REV.CH,18515,17/01/2021,22,-700.0,700.0,GEHEAL Cytiva Europe GmbH,,,,,
9.01.017,RICAVI C/VENDITE ,31/01/2021,150,Giroconto Cessione ,18515,27/01/2021, ,700.0,0.0,GEHEAL Cytiva Europe GmbH,,,,,
9.01.017,RICAVI C/VENDITE ,31/01/2021,229,CESS.COMPENS.REV.CH,2021/44,30/01/2021,23,-34.43,34.43,ALGEN ALGEN S.R.L.,,,,,
9.01.017,RICAVI C/VENDITE ,31/01/2021,150,Giroconto Cessione ,2021/44,30/01/2021, ,34.43,0.0,ALGEN ALGEN S.R.L.,,,,,
9.01.017,RICAVI C/VENDITE ,28/02/2021,217,CESS. COMPENS. ART.,1/A ,15/02/2021,29,-32500.0,32500.0,NOVAUT NOVATEC AUTOMATIZA,,,,,
9.01.017,RICAVI C/VENDITE ,28/02/2021,150,Giroconto Cessione ,1/A ,15/02/2021, ,32500.0,0.0,NOVAUT NOVATEC AUTOMATIZA,,,,,
9.01.017,RICAVI C/VENDITE ,28/02/2021,217,CESS. COMPENS. ART.,2/A ,28/02/2021,30,-32500.0,32500.0,NOVAUT NOVATEC AUTOMATIZA,,,,,
9.01.017,RICAVI C/VENDITE ,28/02/2021,150,Giroconto Cessione ,2/A ,28/02/2021, ,32500.0,0.0,NOVAUT NOVATEC AUTOMATIZA,,,,,
9.01.017,RICAVI C/VENDITE ,28/02/2021,229,CESS.COMPENS.REV.CH,5S.P. ,30/01/2021,31,-36500.0,36500.0,MATECO Mate Consulting S.,,,,,
9.01.017,RICAVI C/VENDITE ,28/02/2021,150,Giroconto Cessione ,5S.P. ,30/01/2021, ,36500.0,0.0,MATECO Mate Consulting S.,,,,,
9.01.017,RICAVI C/VENDITE ,28/02/2021,229,CESS.COMPENS.REV.CH,112,02/02/2021,32,-150.0,150.0,IANCHE IAN CHEM S.R.L. LA,,,,,
9.01.017,RICAVI C/VENDITE ,28/02/2021,150,Giroconto Cessione ,112,02/02/2021, ,150.0,0.0,IANCHE IAN CHEM S.R.L. LA,,,,,
9.01.017,RICAVI C/VENDITE ,28/02/2021,229,CESS.COMPENS.REV.CH,83009,27/01/2021,33,-323.88,323.88,FISHER FISHER SCIENTIFIC,,,,,
9.01.017,RICAVI C/VENDITE ,28/02/2021,150,Giroconto Cessione ,83009,27/01/2021, ,323.88,0.0,FISHER FISHER SCIENTIFIC,,,,,
9.01.017,RICAVI C/VENDITE ,28/02/2021,229,CESS.COMPENS.REV.CH,FPR7/21,31/01/2021,34,-250.0,250.0,NUOQUA NUOVA QUADRIFOGLIO,,,,,
9.01.017,RICAVI C/VENDITE ,28/02/2021,150,Giroconto Cessione ,FPR7/21,31/01/2021, ,250.0,0.0,NUOQUA NUOVA QUADRIFOGLIO,,,,,
9.01.017,RICAVI C/VENDITE ,28/02/2021,229,CESS.COMPENS.REV.CH,329,31/01/2021,35,-35.99,35.99,TECRAI Aruba S.p.A.,,,,,
9.01.017,RICAVI C/VENDITE ,28/02/2021,150,Giroconto Cessione ,329,31/01/2021, ,35.99,0.0,TECRAI Aruba S.p.A.,,,,,
9.01.017,RICAVI C/VENDITE ,28/02/2021,229,CESS.COMPENS.REV.CH,63902,01/02/2021,36,-55.8,55.8,LINKEM LINKEM S.P.A.,,,,,
9.01.017,RICAVI C/VENDITE ,28/02/2021,150,Giroconto Cessione ,63902,01/02/2021, ,55.8,0.0,LINKEM LINKEM S.P.A.,,,,,
9.01.017,RICAVI C/VENDITE ,28/02/2021,229,CESS.COMPENS.REV.CH,4,08/02/2021,37,-3360.0,3360.0,DATTIL DATTILO S.C. A R.L,,,,,
9.01.017,RICAVI C/VENDITE ,28/02/2021,150,Giroconto Cessione ,4,08/02/2021, ,3360.0,0.0,DATTIL DATTILO S.C. A R.L,,,,,
9.01.017,RICAVI C/VENDITE ,28/02/2021,229,CESS.COMPENS.REV.CH,89/21 ,04/02/2021,38,-1900.0,1900.0,NOINTE NOVA INFORMATION T,,,,,
9.01.017,RICAVI C/VENDITE ,28/02/2021,150,Giroconto Cessione ,89/21 ,04/02/2021, ,1900.0,0.0,NOINTE NOVA INFORMATION T,,,,,
9.01.017,RICAVI C/VENDITE ,28/02/2021,229,CESS.COMPENS.REV.CH,FPR1/21,11/02/2021,39,-15200.0,15200.0,EFAIST EFAISTOS S.R.L.,,,,,
9.01.017,RICAVI C/VENDITE ,28/02/2021,150,Giroconto Cessione ,FPR1/21,11/02/2021, ,15200.0,0.0,EFAIST EFAISTOS S.R.L.,,,,,
9.01.017,RICAVI C/VENDITE ,28/02/2021,1229,CESS.COMPENS.REV.CH,98032,11/02/2021,40,145.45,-145.45,SIGMAA SIGMA ALDRICH S.R.,,,,,
9.01.017,RICAVI C/VENDITE ,28/02/2021,160,Giroconto Cessione ,98032,11/02/2021, ,-145.45,0.0,SIGMAA SIGMA ALDRICH S.R.,,,,,
9.01.017,RICAVI C/VENDITE ,28/02/2021,1229,CESS.COMPENS.REV.CH,98033,11/02/2021,41,370.2,-370.2,SIGMAA SIGMA ALDRICH S.R.,,,,,
9.01.017,RICAVI C/VENDITE ,28/02/2021,160,Giroconto Cessione ,98033,11/02/2021, ,-370.2,0.0,SIGMAA SIGMA ALDRICH S.R.,,,,,
9.01.017,RICAVI C/VENDITE ,28/02/2021,1229,CESS.COMPENS.REV.CH,98034,11/02/2021,42,94.0,-94.0,SIGMAA SIGMA ALDRICH S.R.,,,,,
9.01.017,RICAVI C/VENDITE ,28/02/2021,160,Giroconto Cessione ,98034,11/02/2021, ,-94.0,0.0,SIGMAA SIGMA ALDRICH S.R.,,,,,
9.01.017,RICAVI C/VENDITE ,28/02/2021,1229,CESS.COMPENS.REV.CH,98035,11/02/2021,43,54.45,-54.45,SIGMAA SIGMA ALDRICH S.R.,,,,,
9.01.017,RICAVI C/VENDITE ,28/02/2021,160,Giroconto Cessione ,98035,11/02/2021, ,-54.45,0.0,SIGMAA SIGMA ALDRICH S.R.,,,,,
9.01.017,RICAVI C/VENDITE ,28/02/2021,229,CESS.COMPENS.REV.CH,14,31/01/2021,44,-14.44,14.44,SMARTP SMART PIU' S.R.L.,,,,,
9.01.017,RICAVI C/VENDITE ,28/02/2021,150,Giroconto Cessione ,14,31/01/2021, ,14.44,0.0,SMARTP SMART PIU' S.R.L.,,,,,
9.01.017,RICAVI C/VENDITE ,28/02/2021,229,CESS.COMPENS.REV.CH,1,12/02/2021,45,-10004.8,10004.8,ROBCIN ROBERTO CINQUEGRAN,,,,,
9.01.017,RICAVI C/VENDITE ,28/02/2021,150,Giroconto Cessione ,1,12/02/2021, ,10004.8,0.0,ROBCIN ROBERTO CINQUEGRAN,,,,,
9.01.017,RICAVI C/VENDITE ,28/02/2021,2229,CESS.COMPENS.REV.CH,98616,12/02/2021,46,-664.1,664.1,SIGMAA SIGMA ALDRICH S.R.,,,,,
9.01.017,RICAVI C/VENDITE ,28/02/2021,150,Giroconto Cessione ,98616,12/02/2021, ,664.1,0.0,SIGMAA SIGMA ALDRICH S.R.,,,,,
9.01.017,RICAVI C/VENDITE ,28/02/2021,2229,CESS.COMPENS.REV.CH,98617,12/02/2021,47,-447.5,447.5,SIGMAA SIGMA ALDRICH S.R.,,,,,
9.01.017,RICAVI C/VENDITE ,28/02/2021,150,Giroconto Cessione ,98617,12/02/2021, ,447.5,0.0,SIGMAA SIGMA ALDRICH S.R.,,,,,
9.01.017,RICAVI C/VENDITE ,28/02/2021,229,CESS.COMPENS.REV.CH,22351,02/02/2021,48,-13.02,13.02,BANEMI BPER BANCA S.P.A.,,,,,
9.01.017,RICAVI C/VENDITE ,28/02/2021,150,Giroconto Cessione ,22351,02/02/2021, ,13.02,0.0,BANEMI BPER BANCA S.P.A.,,,,,
9.01.017,RICAVI C/VENDITE ,28/02/2021,229,CESS.COMPENS.REV.CH,516 A ,17/02/2021,49,-656.0,656.0,DBA D.B.A. ITALIA S.R.,,,,,
9.01.017,RICAVI C/VENDITE ,28/02/2021,150,Giroconto Cessione ,516 A ,17/02/2021, ,656.0,0.0,DBA D.B.A. ITALIA S.R.,,,,,
9.01.017,RICAVI C/VENDITE ,28/02/2021,229,CESS.COMPENS.REV.CH,526 A ,19/02/2021,50,-234.0,234.0,DBA D.B.A. ITALIA S.R.,,,,,
9.01.017,RICAVI C/VENDITE ,28/02/2021,150,Giroconto Cessione ,526 A ,19/02/2021, ,234.0,0.0,DBA D.B.A. ITALIA S.R.,,,,,
9.01.017,RICAVI C/VENDITE ,28/02/2021,229,CESS.COMPENS.REV.CH,5000953,22/02/2021,51,-45328.2,45328.2,METROH Metrohm Italiana S,,,,,
9.01.017,RICAVI C/VENDITE ,28/02/2021,150,Giroconto Cessione ,5000953,22/02/2021, ,45328.2,0.0,METROH Metrohm Italiana S,,,,,
9.01.017,RICAVI C/VENDITE ,28/02/2021,229,CESS.COMPENS.REV.CH,62/2021,22/02/2021,52,-1731.66,1731.66,DBELE DB ELECTRONIC INST,,,,,
9.01.017,RICAVI C/VENDITE ,28/02/2021,150,Giroconto Cessione ,62/2021,22/02/2021, ,1731.66,0.0,DBELE DB ELECTRONIC INST,,,,,
9.01.017,RICAVI C/VENDITE ,28/02/2021,229,CESS.COMPENS.REV.CH,204112,22/02/2021,53,-498.0,498.0,SIGMAA SIGMA ALDRICH S.R.,,,,,
9.01.017,RICAVI C/VENDITE ,28/02/2021,150,Giroconto Cessione ,204112,22/02/2021, ,498.0,0.0,SIGMAA SIGMA ALDRICH S.R.,,,,,
9.01.017,RICAVI C/VENDITE ,28/02/2021,229,CESS.COMPENS.REV.CH,11,22/02/2021,54,-12510.31,12510.31,DAMBGI DITTA D'AMBRA GIUS,,,,,
9.01.017,RICAVI C/VENDITE ,28/02/2021,150,Giroconto Cessione ,11,22/02/2021, ,12510.31,0.0,DAMBGI DITTA D'AMBRA GIUS,,,,,
9.01.017,RICAVI C/VENDITE ,28/02/2021,229,CESS.COMPENS.REV.CH,47,26/02/2021,55,-69.09,69.09,GBVEND GB VENDING SRLS,,,,,
9.01.017,RICAVI C/VENDITE ,28/02/2021,150,Giroconto Cessione ,47,26/02/2021, ,69.09,0.0,GBVEND GB VENDING SRLS,,,,,
9.01.017,RICAVI C/VENDITE ,28/02/2021,229,CESS.COMPENS.REV.CH,71/2021,26/02/2021,56,-611.41,611.41,DBELE DB ELECTRONIC INST,,,,,
9.01.017,RICAVI C/VENDITE ,28/02/2021,150,Giroconto Cessione ,71/2021,26/02/2021, ,611.41,0.0,DBELE DB ELECTRONIC INST,,,,,
9.01.017,RICAVI C/VENDITE ,31/03/2021,229,CESS.COMPENS.REV.CH,9225,02/03/2021,57,-224.4,224.4,SIGMAA SIGMA ALDRICH S.R.,,,,,
9.01.017,RICAVI C/VENDITE ,31/03/2021,150,Giroconto Cessione ,9225,02/03/2021, ,224.4,0.0,SIGMAA SIGMA ALDRICH S.R.,,,,,
9.01.017,RICAVI C/VENDITE ,31/03/2021,229,CESS.COMPENS.REV.CH,113,28/02/2021,58,-116.37,116.37,ALGEN ALGEN S.R.L.,,,,,
9.01.017,RICAVI C/VENDITE ,31/03/2021,150,Giroconto Cessione ,113,28/02/2021, ,116.37,0.0,ALGEN ALGEN S.R.L.,,,,,
9.01.017,RICAVI C/VENDITE ,31/03/2021,229,CESS.COMPENS.REV.CH,26290,28/02/2021,59,-31.5,31.5,SIAD S.I.A.D. S.P.A.,,,,,
9.01.017,RICAVI C/VENDITE ,31/03/2021,150,Giroconto Cessione ,26290,28/02/2021, ,31.5,0.0,SIAD S.I.A.D. S.P.A.,,,,,
9.01.017,RICAVI C/VENDITE ,31/03/2021,229,CESS.COMPENS.REV.CH,747,28/02/2021,60,-15.8,15.8,TECRAI Aruba S.p.A.,,,,,
9.01.017,RICAVI C/VENDITE ,31/03/2021,150,Giroconto Cessione ,747,28/02/2021, ,15.8,0.0,TECRAI Aruba S.p.A.,,,,,
9.01.017,RICAVI C/VENDITE ,31/03/2021,229,CESS.COMPENS.REV.CH,86/2021,05/03/2021,61,-579.14,579.14,DBELE DB ELECTRONIC INST,,,,,
9.01.017,RICAVI C/VENDITE ,31/03/2021,150,Giroconto Cessione ,86/2021,05/03/2021, ,579.14,0.0,DBELE DB ELECTRONIC INST,,,,,
9.01.017,RICAVI C/VENDITE ,31/03/2021,229,CESS.COMPENS.REV.CH,30/FV21,08/03/2021,62,-30000.0,30000.0,ACKSRL Ack S.r.l.,,,,,
9.01.017,RICAVI C/VENDITE ,31/03/2021,150,Giroconto Cessione ,30/FV21,08/03/2021, ,30000.0,0.0,ACKSRL Ack S.r.l.,,,,,
9.01.017,RICAVI C/VENDITE ,31/03/2021,229,CESS.COMPENS.REV.CH,58,09/03/2021,63,-70.0,70.0,POLSER POLITECNO SERVICE,,,,,
9.01.017,RICAVI C/VENDITE ,31/03/2021,150,Giroconto Cessione ,58,09/03/2021, ,70.0,0.0,POLSER POLITECNO SERVICE,,,,,
9.01.017,RICAVI C/VENDITE ,31/03/2021,229,CESS.COMPENS.REV.CH,12373,08/03/2021,65,-76.6,76.6,SIGMAA SIGMA ALDRICH S.R.,,,,,
9.01.017,RICAVI C/VENDITE ,31/03/2021,150,Giroconto Cessione ,12373,08/03/2021, ,76.6,0.0,SIGMAA SIGMA ALDRICH S.R.,,,,,
9.01.017,RICAVI C/VENDITE ,31/03/2021,229,CESS.COMPENS.REV.CH,30/PRSP,09/03/2021,66,-1640.0,1640.0,SIALSR S.I.A.L. SRL,,,,,
9.01.017,RICAVI C/VENDITE ,31/03/2021,150,Giroconto Cessione ,30/PRSP,09/03/2021, ,1640.0,0.0,SIALSR S.I.A.L. SRL,,,,,
9.01.017,RICAVI C/VENDITE ,31/03/2021,229,CESS.COMPENS.REV.CH,FPR58 ,10/03/2021,67,-300.0,300.0,NUOQUA NUOVA QUADRIFOGLIO,,,,,
9.01.017,RICAVI C/VENDITE ,31/03/2021,150,Giroconto Cessione ,FPR58 ,10/03/2021, ,300.0,0.0,NUOQUA NUOVA QUADRIFOGLIO,,,,,
9.01.017,RICAVI C/VENDITE ,31/03/2021,229,CESS.COMPENS.REV.CH,30547,02/03/2021,68,-13.02,13.02,BANEMI BPER BANCA S.P.A.,,,,,
9.01.017,RICAVI C/VENDITE ,31/03/2021,150,Giroconto Cessione ,30547,02/03/2021, ,13.02,0.0,BANEMI BPER BANCA S.P.A.,,,,,
9.01.017,RICAVI C/VENDITE ,31/03/2021,229,CESS.COMPENS.REV.CH,4655/21,15/03/2021,69,-346.58,346.58,PACKSE PACK SERVICES S.R.,,,,,
9.01.017,RICAVI C/VENDITE ,31/03/2021,150,Giroconto Cessione ,4655/21,15/03/2021, ,346.58,0.0,PACKSE PACK SERVICES S.R.,,,,,
9.01.017,RICAVI C/VENDITE ,31/03/2021,229,CESS.COMPENS.REV.CH,9770/V1,15/03/2021,70,-5.17,5.17,ELECAM ELETTROCAMPANIA S.,,,,,
9.01.017,RICAVI C/VENDITE ,31/03/2021,150,Giroconto Cessione ,9770/V1,15/03/2021, ,5.17,0.0,ELECAM ELETTROCAMPANIA S.,,,,,
9.01.017,RICAVI C/VENDITE ,31/03/2021,229,CESS.COMPENS.REV.CH,16989,16/03/2021,71,-146.0,146.0,SIGMAA SIGMA ALDRICH S.R.,,,,,
9.01.017,RICAVI C/VENDITE ,31/03/2021,150,Giroconto Cessione ,16989,16/03/2021, ,146.0,0.0,SIGMAA SIGMA ALDRICH S.R.,,,,,
9.01.017,RICAVI C/VENDITE ,31/03/2021,229,CESS.COMPENS.REV.CH,31/PRSP,17/03/2021,72,-945.0,945.0,SIALSR S.I.A.L. SRL,,,,,
9.01.017,RICAVI C/VENDITE ,31/03/2021,150,Giroconto Cessione ,31/PRSP,17/03/2021, ,945.0,0.0,SIALSR S.I.A.L. SRL,,,,,
9.01.017,RICAVI C/VENDITE ,31/03/2021,229,CESS.COMPENS.REV.CH,17796,17/03/2021,73,-147.0,147.0,SIGMAA SIGMA ALDRICH S.R.,,,,,
9.01.017,RICAVI C/VENDITE ,31/03/2021,150,Giroconto Cessione ,17796,17/03/2021, ,147.0,0.0,SIGMAA SIGMA ALDRICH S.R.,,,,,
9.01.017,RICAVI C/VENDITE ,31/03/2021,229,CESS.COMPENS.REV.CH,40/2021,19/03/2021,74,-1490.0,1490.0,ANTVET ANTONIO VETRONE,,,,,
9.01.017,RICAVI C/VENDITE ,31/03/2021,150,Giroconto Cessione ,40/2021,19/03/2021, ,1490.0,0.0,ANTVET ANTONIO VETRONE,,,,,
9.01.017,RICAVI C/VENDITE ,31/03/2021,229,CESS.COMPENS.REV.CH,91042,20/03/2021,75,-567.93,567.93,VODAFO VODAFONE ITALIA S.,,,,,
9.01.017,RICAVI C/VENDITE ,31/03/2021,150,Giroconto Cessione ,91042,20/03/2021, ,567.93,0.0,VODAFO VODAFONE ITALIA S.,,,,,
9.01.017,RICAVI C/VENDITE ,31/03/2021,229,CESS.COMPENS.REV.CH,182985,24/03/2021,76,-393.43,393.43,AMAEU Amazon EU S.a r.l.,,,,,
9.01.017,RICAVI C/VENDITE ,31/03/2021,150,Giroconto Cessione ,182985,24/03/2021, ,393.43,0.0,AMAEU Amazon EU S.a r.l.,,,,,
9.01.017,RICAVI C/VENDITE ,31/03/2021,229,CESS.COMPENS.REV.CH,15A ,24/03/2021,77,-22000.0,22000.0,MAXFON MAXFON S.R.L.,,,,,
9.01.017,RICAVI C/VENDITE ,31/03/2021,150,Giroconto Cessione ,15A ,24/03/2021, ,22000.0,0.0,MAXFON MAXFON S.R.L.,,,,,
9.01.017,RICAVI C/VENDITE ,31/03/2021,229,CESS.COMPENS.REV.CH,5,25/03/2021,78,-30000.0,30000.0,ELIGIT ELIGITE S.R.L.,,,,,
9.01.017,RICAVI C/VENDITE ,31/03/2021,150,Giroconto Cessione ,5,25/03/2021, ,30000.0,0.0,ELIGIT ELIGITE S.R.L.,,,,,
9.01.017,RICAVI C/VENDITE ,31/03/2021,229,CESS.COMPENS.REV.CH,24,26/03/2021,79,-4416.86,4416.86,DAMBGI DITTA D'AMBRA GIUS,,,,,
9.01.017,RICAVI C/VENDITE ,31/03/2021,150,Giroconto Cessione ,24,26/03/2021, ,4416.86,0.0,DAMBGI DITTA D'AMBRA GIUS,,,,,
9.01.017,RICAVI C/VENDITE ,30/04/2021,229,CESS.COMPENS.REV.CH,036-21 ,30/03/2021,83,-1898.0,1898.0,DORATE DORA TECNOLOGIE DI,,,,,
9.01.017,RICAVI C/VENDITE ,30/04/2021,150,Giroconto Cessione ,036-21 ,30/03/2021, ,1898.0,0.0,DORATE DORA TECNOLOGIE DI,,,,,
9.01.017,RICAVI C/VENDITE ,30/04/2021,229,CESS.COMPENS.REV.CH,223,31/03/2021,84,-10.65,10.65,ALGEN ALGEN S.R.L.,,,,,
9.01.017,RICAVI C/VENDITE ,30/04/2021,150,Giroconto Cessione ,223,31/03/2021, ,10.65,0.0,ALGEN ALGEN S.R.L.,,,,,
9.01.017,RICAVI C/VENDITE ,30/04/2021,229,CESS.COMPENS.REV.CH,36173,03/04/2021,86,-54.4,54.4,LINKEM LINKEM S.P.A.,,,,,
9.01.017,RICAVI C/VENDITE ,30/04/2021,150,Giroconto Cessione ,36173,03/04/2021, ,54.4,0.0,LINKEM LINKEM S.P.A.,,,,,
9.01.017,RICAVI C/VENDITE ,30/04/2021,229,CESS.COMPENS.REV.CH,1197,31/03/2021,87,-95.89,95.89,TECRAI Aruba S.p.A.,,,,,
9.01.017,RICAVI C/VENDITE ,30/04/2021,150,Giroconto Cessione ,1197,31/03/2021, ,95.89,0.0,TECRAI Aruba S.p.A.,,,,,
9.01.017,RICAVI C/VENDITE ,30/04/2021,229,CESS.COMPENS.REV.CH,M44259 ,07/04/2021,88,-1294.99,1294.99,EDENRE EDENRED ITALIA Srl,,,,,
9.01.017,RICAVI C/VENDITE ,30/04/2021,150,Giroconto Cessione ,M44259 ,07/04/2021, ,1294.99,0.0,EDENRE EDENRED ITALIA Srl,,,,,
9.01.017,RICAVI C/VENDITE ,30/04/2021,229,CESS.COMPENS.REV.CH,FPR71 ,31/03/2021,89,-300.0,300.0,NUOQUA NUOVA QUADRIFOGLIO,,,,,
9.01.017,RICAVI C/VENDITE ,30/04/2021,150,Giroconto Cessione ,FPR71 ,31/03/2021, ,300.0,0.0,NUOQUA NUOVA QUADRIFOGLIO,,,,,
9.01.017,RICAVI C/VENDITE ,30/04/2021,229,CESS.COMPENS.REV.CH,FPR9/21,09/04/2021,90,-5000.0,5000.0,KRATOS KRATOS S.R.L.,,,,,
9.01.017,RICAVI C/VENDITE ,30/04/2021,150,Giroconto Cessione ,FPR9/21,09/04/2021, ,5000.0,0.0,KRATOS KRATOS S.R.L.,,,,,
9.01.017,RICAVI C/VENDITE ,30/04/2021,229,CESS.COMPENS.REV.CH,33/BB00,02/04/2021,91,-105.0,105.0,RSTORE R-Store S.p.A.,,,,,
9.01.017,RICAVI C/VENDITE ,30/04/2021,150,Giroconto Cessione ,33/BB00,02/04/2021, ,105.0,0.0,RSTORE R-Store S.p.A.,,,,,
9.01.017,RICAVI C/VENDITE ,30/04/2021,229,CESS.COMPENS.REV.CH,33,09/04/2021,92,-1800.0,1800.0,START START-UP IMPRESA S,,,,,
9.01.017,RICAVI C/VENDITE ,30/04/2021,150,Giroconto Cessione ,33,09/04/2021, ,1800.0,0.0,START START-UP IMPRESA S,,,,,
9.01.017,RICAVI C/VENDITE ,30/04/2021,229,CESS.COMPENS.REV.CH,74/BB00,06/04/2021,93,-3075.5,3075.5,RSTORE R-Store S.p.A.,,,,,
9.01.017,RICAVI C/VENDITE ,30/04/2021,150,Giroconto Cessione ,74/BB00,06/04/2021, ,3075.5,0.0,RSTORE R-Store S.p.A.,,,,,
9.01.017,RICAVI C/VENDITE ,30/04/2021,229,CESS.COMPENS.REV.CH,102,31/03/2021,94,-4.98,4.98,SMARTP SMART PIU' S.R.L.,,,,,
9.01.017,RICAVI C/VENDITE ,30/04/2021,150,Giroconto Cessione ,102,31/03/2021, ,4.98,0.0,SMARTP SMART PIU' S.R.L.,,,,,
9.01.017,RICAVI C/VENDITE ,30/04/2021,229,CESS.COMPENS.REV.CH,39803,02/04/2021,95,-13.02,13.02,BANEMI BPER BANCA S.P.A.,,,,,
9.01.017,RICAVI C/VENDITE ,30/04/2021,150,Giroconto Cessione ,39803,02/04/2021, ,13.02,0.0,BANEMI BPER BANCA S.P.A.,,,,,
9.01.017,RICAVI C/VENDITE ,30/04/2021,229,CESS.COMPENS.REV.CH,88671,14/04/2021,96,-323.88,323.88,FISHER FISHER SCIENTIFIC,,,,,
9.01.017,RICAVI C/VENDITE ,30/04/2021,150,Giroconto Cessione ,88671,14/04/2021, ,323.88,0.0,FISHER FISHER SCIENTIFIC,,,,,
9.01.017,RICAVI C/VENDITE ,30/04/2021,229,CESS.COMPENS.REV.CH,48792,31/03/2021,85,-199.4,199.4,SIAD S.I.A.D. S.P.A.,,,,,
9.01.017,RICAVI C/VENDITE ,30/04/2021,1229,CESS.COMPENS.REV.CH,88933,16/04/2021,97,1627.82,-1428.42,FISHER FISHER SCIENTIFIC,,,,,
9.01.017,RICAVI C/VENDITE ,30/04/2021,160,Giroconto Cessione ,88933,16/04/2021, ,-1627.82,199.4000000000001,FISHER FISHER SCIENTIFIC,,,,,
9.01.017,RICAVI C/VENDITE ,30/04/2021,229,CESS.COMPENS.REV.CH,89008,19/04/2021,98,-1627.82,1827.22,FISHER FISHER SCIENTIFIC,,,,,
9.01.017,RICAVI C/VENDITE ,30/04/2021,150,Giroconto Cessione ,89008,19/04/2021, ,1627.82,199.4000000000001,FISHER FISHER SCIENTIFIC,,,,,
9.01.017,RICAVI C/VENDITE ,30/04/2021,229,CESS.COMPENS.REV.CH,FPR12 ,20/04/2021,99,-106500.0,106699.4,KRATOS KRATOS S.R.L.,,,,,
9.01.017,RICAVI C/VENDITE ,30/04/2021,150,Giroconto Cessione ,FPR12 ,20/04/2021, ,106500.0,199.3999999999942,KRATOS KRATOS S.R.L.,,,,,
9.01.017,RICAVI C/VENDITE ,30/04/2021,229,CESS.COMPENS.REV.CH,FPR36 ,20/04/2021,100,-12721.0,12920.39999999999,OKOLAB okolab s.r.l.,,,,,
9.01.017,RICAVI C/VENDITE ,30/04/2021,150,Giroconto Cessione ,FPR36 ,20/04/2021, ,12721.0,199.3999999999942,OKOLAB okolab s.r.l.,,,,,
9.01.017,RICAVI C/VENDITE ,30/04/2021,229,CESS.COMPENS.REV.CH,124,21/04/2021,101,-337.98,537.3799999999942,DBELE DB ELECTRONIC INST,,,,,
9.01.017,RICAVI C/VENDITE ,30/04/2021,150,Giroconto Cessione ,124,21/04/2021, ,337.98,199.3999999999942,DBELE DB ELECTRONIC INST,,,,,
9.01.017,RICAVI C/VENDITE ,30/04/2021,229,CESS.COMPENS.REV.CH,FPR9/21,22/04/2021,102,-785.36,984.7599999999942,ICTSUD CENTRO DI COMPETEN,,,,,
9.01.017,RICAVI C/VENDITE ,30/04/2021,150,Giroconto Cessione ,FPR9/21,22/04/2021, ,785.36,199.3999999999942,ICTSUD CENTRO DI COMPETEN,,,,,
9.01.017,RICAVI C/VENDITE ,30/04/2021,229,CESS.COMPENS.REV.CH,40,23/04/2021,103,-120.0,319.3999999999942,DAMBGI DITTA D'AMBRA GIUS,,,,,
9.01.017,RICAVI C/VENDITE ,30/04/2021,150,Giroconto Cessione ,40,23/04/2021, ,120.0,199.3999999999942,DAMBGI DITTA D'AMBRA GIUS,,,,,
9.01.017,RICAVI C/VENDITE ,30/04/2021,229,CESS.COMPENS.REV.CH,1153,26/04/2021,104,-1315.0,1514.399999999994,NOTGER NOTARBARTOLO & GER,,,,,
9.01.017,RICAVI C/VENDITE ,30/04/2021,150,Giroconto Cessione ,1153,26/04/2021, ,1315.0,199.3999999999942,NOTGER NOTARBARTOLO & GER,,,,,
9.01.017,RICAVI C/VENDITE ,30/04/2021,229,CESS.COMPENS.REV.CH,258/E ,29/04/2021,106,-6301.0,6500.399999999994,NANOVI NANOVISION S.R.L.,,,,,
9.01.017,RICAVI C/VENDITE ,30/04/2021,150,Giroconto Cessione ,258/E ,29/04/2021, ,6301.0,199.3999999999942,NANOVI NANOVISION S.R.L.,,,,,
9.01.017,RICAVI C/VENDITE ,30/04/2021,229,CESS.COMPENS.REV.CH,41602,30/04/2021,107,-630.4,829.7999999999942,SIGMAA SIGMA ALDRICH S.R.,,,,,
9.01.017,RICAVI C/VENDITE ,30/04/2021,150,Giroconto Cessione ,41602,30/04/2021, ,630.4,199.3999999999942,SIGMAA SIGMA ALDRICH S.R.,,,,,
9.01.017,RICAVI C/VENDITE ,10/05/2021,150,Giroconto Cessione ,48792,31/03/2021, ,199.4,-5.826450433232822e-12,SIAD S.I.A.D. S.P.A.,,,,,
9.01.017,RICAVI C/VENDITE ,31/05/2021,229,CESS.COMPENS.REV.CH,10/SP ,30/04/2021,110,-135.0,134.9999999999942,SIDSPA SIDERSAN SPA,,,,,
9.01.017,RICAVI C/VENDITE ,31/05/2021,150,Giroconto Cessione ,10/SP ,30/04/2021, ,135.0,-5.826450433232822e-12,SIDSPA SIDERSAN SPA,,,,,
9.01.017,RICAVI C/VENDITE ,31/05/2021,229,CESS.COMPENS.REV.CH,36007,30/04/2021,111,-101.5,101.4999999999942,VWR VWR INTERNATIONAL,,,,,
9.01.017,RICAVI C/VENDITE ,31/05/2021,150,Giroconto Cessione ,36007,30/04/2021, ,101.5,-5.826450433232822e-12,VWR VWR INTERNATIONAL,,,,,
9.01.017,RICAVI C/VENDITE ,31/05/2021,229,CESS.COMPENS.REV.CH,302,30/04/2021,112,-204.92,204.9199999999942,ALGEN ALGEN S.R.L.,,,,,
9.01.017,RICAVI C/VENDITE ,31/05/2021,150,Giroconto Cessione ,302,30/04/2021, ,204.92,-5.826450433232822e-12,ALGEN ALGEN S.R.L.,,,,,
9.01.017,RICAVI C/VENDITE ,31/05/2021,229,CESS.COMPENS.REV.CH,325,30/04/2021,113,-160.0,159.9999999999942,ASESRL ASE S.R.L.,,,,,
9.01.017,RICAVI C/VENDITE ,31/05/2021,150,Giroconto Cessione ,325,30/04/2021, ,160.0,-5.826450433232822e-12,ASESRL ASE S.R.L.,,,,,
9.01.017,RICAVI C/VENDITE ,31/05/2021,229,CESS.COMPENS.REV.CH,311,30/04/2021,114,-180.2,180.1999999999942,OPTOTE OPTOTECH S.R.L.,,,,,
9.01.017,RICAVI C/VENDITE ,31/05/2021,150,Giroconto Cessione ,311,30/04/2021, ,180.2,-5.826450433232822e-12,OPTOTE OPTOTECH S.R.L.,,,,,
9.01.017,RICAVI C/VENDITE ,31/05/2021,229,CESS.COMPENS.REV.CH,104,04/05/2021,115,-76.23,76.22999999999418,GBVEND GB VENDING SRLS,,,,,
9.01.017,RICAVI C/VENDITE ,31/05/2021,150,Giroconto Cessione ,104,04/05/2021, ,76.23,-5.826450433232822e-12,GBVEND GB VENDING SRLS,,,,,
9.01.017,RICAVI C/VENDITE ,31/05/2021,229,CESS.COMPENS.REV.CH,136,03/05/2021,116,-271.49,271.4899999999942,DBELE DB ELECTRONIC INST,,,,,
9.01.017,RICAVI C/VENDITE ,31/05/2021,150,Giroconto Cessione ,136,03/05/2021, ,271.49,-5.798028723802418e-12,DBELE DB ELECTRONIC INST,,,,,
9.01.017,RICAVI C/VENDITE ,31/05/2021,229,CESS.COMPENS.REV.CH,69/PRSP,04/05/2021,117,-910.0,909.9999999999942,SIALSR S.I.A.L. SRL,,,,,
9.01.017,RICAVI C/VENDITE ,31/05/2021,150,Giroconto Cessione ,69/PRSP,04/05/2021, ,910.0,-5.798028723802418e-12,SIALSR S.I.A.L. SRL,,,,,
9.01.017,RICAVI C/VENDITE ,31/05/2021,1229,CESS.COMPENS.REV.CH,04/NC ,12/05/2021,118,320.0,-320.0000000000058,CAPUOZ CAPUOZZO S.R.L.,,,,,
9.01.017,RICAVI C/VENDITE ,31/05/2021,160,Giroconto Cessione ,04/NC ,12/05/2021, ,-320.0,-5.798028723802418e-12,CAPUOZ CAPUOZZO S.R.L.,,,,,
9.01.017,RICAVI C/VENDITE ,31/05/2021,229,CESS.COMPENS.REV.CH,05/P.A.,12/05/2021,119,-320.0,319.9999999999942,CAPUOZ CAPUOZZO S.R.L.,,,,,
9.01.017,RICAVI C/VENDITE ,31/05/2021,150,Giroconto Cessione ,05/P.A.,12/05/2021, ,320.0,-5.798028723802418e-12,CAPUOZ CAPUOZZO S.R.L.,,,,,
9.01.017,RICAVI C/VENDITE ,31/05/2021,229,CESS.COMPENS.REV.CH,138,30/04/2021,120,-5.0,4.999999999994202,SMARTP SMART PIU' S.R.L.,,,,,
9.01.017,RICAVI C/VENDITE ,31/05/2021,150,Giroconto Cessione ,138,30/04/2021, ,5.0,-5.798028723802418e-12,SMARTP SMART PIU' S.R.L.,,,,,
9.01.017,RICAVI C/VENDITE ,31/05/2021,229,CESS.COMPENS.REV.CH,FPR115 ,14/05/2021,121,-200.0,199.9999999999942,NUOQUA NUOVA QUADRIFOGLIO,,,,,
9.01.017,RICAVI C/VENDITE ,31/05/2021,150,Giroconto Cessione ,FPR115 ,14/05/2021, ,200.0,-5.798028723802418e-12,NUOQUA NUOVA QUADRIFOGLIO,,,,,
9.01.017,RICAVI C/VENDITE ,31/05/2021,1229,CESS.COMPENS.REV.CH,98036,11/02/2021,122,37.5,-37.5000000000058,SIGMAA SIGMA ALDRICH S.R.,,,,,
9.01.017,RICAVI C/VENDITE ,31/05/2021,160,Giroconto Cessione ,98036,11/02/2021, ,-37.5,-5.798028723802418e-12,SIGMAA SIGMA ALDRICH S.R.,,,,,
9.01.017,RICAVI C/VENDITE ,31/05/2021,1229,CESS.COMPENS.REV.CH,98037,11/02/2021,123,410.0,-410.0000000000058,SIGMAA SIGMA ALDRICH S.R.,,,,,
9.01.017,RICAVI C/VENDITE ,31/05/2021,160,Giroconto Cessione ,98037,11/02/2021, ,-410.0,-5.798028723802418e-12,SIGMAA SIGMA ALDRICH S.R.,,,,,
9.01.017,RICAVI C/VENDITE ,31/05/2021,229,CESS.COMPENS.REV.CH,13 / PA,17/05/2021,124,-1572.6,1572.599999999994,TRTURO T.R. TURONI S.R.L.,,,,,
9.01.017,RICAVI C/VENDITE ,31/05/2021,150,Giroconto Cessione ,13 / PA,17/05/2021, ,1572.6,-5.911715561524034e-12,TRTURO T.R. TURONI S.R.L.,,,,,
9.01.017,RICAVI C/VENDITE ,31/05/2021,229,CESS.COMPENS.REV.CH,3FE ,14/05/2021,125,-200.0,199.9999999999941,SPICIS SPICI SRL - SOC. P,,,,,
9.01.017,RICAVI C/VENDITE ,31/05/2021,150,Giroconto Cessione ,3FE ,14/05/2021, ,200.0,-5.911715561524034e-12,SPICIS SPICI SRL - SOC. P,,,,,
9.01.017,RICAVI C/VENDITE ,31/05/2021,229,CESS.COMPENS.REV.CH,19474,17/05/2021,126,-832.2,832.1999999999941,GEHEAL Cytiva Europe GmbH,,,,,
9.01.017,RICAVI C/VENDITE ,31/05/2021,150,Giroconto Cessione ,19474,17/05/2021, ,832.2,-5.911715561524034e-12,GEHEAL Cytiva Europe GmbH,,,,,
9.01.017,RICAVI C/VENDITE ,31/05/2021,229,CESS.COMPENS.REV.CH,49781,04/05/2021,127,-13.02,13.01999999999409,BANEMI BPER BANCA S.P.A.,,,,,
9.01.017,RICAVI C/VENDITE ,31/05/2021,150,Giroconto Cessione ,49781,04/05/2021, ,13.02,-5.911715561524034e-12,BANEMI BPER BANCA S.P.A.,,,,,
9.01.017,RICAVI C/VENDITE ,31/05/2021,229,CESS.COMPENS.REV.CH,22474,20/05/2021,128,-1237.6,1237.599999999994,SARTO1 Sartorius Italy S.,,,,,
9.01.017,RICAVI C/VENDITE ,31/05/2021,150,Giroconto Cessione ,22474,20/05/2021, ,1237.6,-5.911715561524034e-12,SARTO1 Sartorius Italy S.,,,,,
9.01.017,RICAVI C/VENDITE ,31/05/2021,229,CESS.COMPENS.REV.CH,1219,20/05/2021,129,-3946.0,3945.999999999994,OPTOTR OPTOTRIM S.R.L.,,,,,
9.01.017,RICAVI C/VENDITE ,31/05/2021,150,Giroconto Cessione ,1219,20/05/2021, ,3946.0,-5.911715561524034e-12,OPTOTR OPTOTRIM S.R.L.,,,,,
9.01.017,RICAVI C/VENDITE ,31/05/2021,229,CESS.COMPENS.REV.CH,907815,20/05/2021,130,-575.8,575.799999999994,VODAFO VODAFONE ITALIA S.,,,,,
9.01.017,RICAVI C/VENDITE ,31/05/2021,150,Giroconto Cessione ,907815,20/05/2021, ,575.8,-5.911715561524034e-12,VODAFO VODAFONE ITALIA S.,,,,,
9.01.017,RICAVI C/VENDITE ,31/05/2021,229,CESS.COMPENS.REV.CH,214,24/05/2021,131,-332.0,331.9999999999941,ECOSEA ECOSEARCH S.R.L.,,,,,
9.01.017,RICAVI C/VENDITE ,31/05/2021,150,Giroconto Cessione ,214,24/05/2021, ,332.0,-5.911715561524034e-12,ECOSEA ECOSEARCH S.R.L.,,,,,
9.01.017,RICAVI C/VENDITE ,31/05/2021,229,CESS.COMPENS.REV.CH,1286,26/05/2021,133,-358.0,357.9999999999941,OPTOTR OPTOTRIM S.R.L.,,,,,
9.01.017,RICAVI C/VENDITE ,31/05/2021,150,Giroconto Cessione ,1286,26/05/2021, ,358.0,-5.911715561524034e-12,OPTOTR OPTOTRIM S.R.L.,,,,,
9.01.017,RICAVI C/VENDITE ,30/06/2021,229,CESS.COMPENS.REV.CH,14/SP ,31/05/2021,140,-19.87,19.86999999999409,SIDSPA SIDERSAN SPA,,,,,
9.01.017,RICAVI C/VENDITE ,30/06/2021,150,Giroconto Cessione ,14/SP ,31/05/2021, ,19.87,-5.911715561524034e-12,SIDSPA SIDERSAN SPA,,,,,
9.01.017,RICAVI C/VENDITE ,30/06/2021,229,CESS.COMPENS.REV.CH,355,31/05/2021,141,-305.74,305.7399999999941,ALGEN ALGEN S.R.L.,,,,,
9.01.017,RICAVI C/VENDITE ,30/06/2021,150,Giroconto Cessione ,355,31/05/2021, ,305.74,-5.911715561524034e-12,ALGEN ALGEN S.R.L.,,,,,
9.01.017,RICAVI C/VENDITE ,30/06/2021,229,CESS.COMPENS.REV.CH,78018,31/05/2021,143,-36.47,36.46999999999409,SIAD S.I.A.D. S.P.A.,,,,,
9.01.017,RICAVI C/VENDITE ,30/06/2021,150,Giroconto Cessione ,78018,31/05/2021, ,36.47,-5.911715561524034e-12,SIAD S.I.A.D. S.P.A.,,,,,
9.01.017,RICAVI C/VENDITE ,30/06/2021,229,CESS.COMPENS.REV.CH,178,07/06/2021,144,-298.27,298.2699999999941,DBELE DB ELECTRONIC INST,,,,,
9.01.017,RICAVI C/VENDITE ,30/06/2021,150,Giroconto Cessione ,178,07/06/2021, ,298.27,-5.911715561524034e-12,DBELE DB ELECTRONIC INST,,,,,
9.01.017,RICAVI C/VENDITE ,30/06/2021,229,CESS.COMPENS.REV.CH,68,09/06/2021,145,-442.0,441.9999999999941,MISURE MISURE S.N.C. DI B,,,,,
9.01.017,RICAVI C/VENDITE ,30/06/2021,150,Giroconto Cessione ,68,09/06/2021, ,442.0,-5.911715561524034e-12,MISURE MISURE S.N.C. DI B,,,,,
9.01.017,RICAVI C/VENDITE ,30/06/2021,229,CESS.COMPENS.REV.CH,64882,10/06/2021,147,-363.9,363.8999999999941,SIGMAA SIGMA ALDRICH S.R.,,,,,
9.01.017,RICAVI C/VENDITE ,30/06/2021,150,Giroconto Cessione ,64882,10/06/2021, ,363.9,-5.911715561524034e-12,SIGMAA SIGMA ALDRICH S.R.,,,,,
9.01.017,RICAVI C/VENDITE ,30/06/2021,229,CESS.COMPENS.REV.CH,206,31/05/2021,148,-165.05,165.0499999999941,SMARTP SMART PIU' S.R.L.,,,,,
9.01.017,RICAVI C/VENDITE ,30/06/2021,150,Giroconto Cessione ,206,31/05/2021, ,165.05,-5.911715561524034e-12,SMARTP SMART PIU' S.R.L.,,,,,
9.01.017,RICAVI C/VENDITE ,30/06/2021,229,CESS.COMPENS.REV.CH,FPR133 ,14/06/2021,149,-300.0,299.9999999999941,NUOQUA NUOVA QUADRIFOGLIO,,,,,
9.01.017,RICAVI C/VENDITE ,30/06/2021,150,Giroconto Cessione ,FPR133 ,14/06/2021, ,300.0,-5.911715561524034e-12,NUOQUA NUOVA QUADRIFOGLIO,,,,,
9.01.017,RICAVI C/VENDITE ,30/06/2021,1229,CESS.COMPENS.REV.CH,93373,15/06/2021,150,323.88,-323.8800000000059,FISHER FISHER SCIENTIFIC,,,,,
9.01.017,RICAVI C/VENDITE ,30/06/2021,160,Giroconto Cessione ,93373,15/06/2021, ,-323.88,-5.911715561524034e-12,FISHER FISHER SCIENTIFIC,,,,,
9.01.017,RICAVI C/VENDITE ,30/06/2021,229,CESS.COMPENS.REV.CH,59 / 4 ,04/06/2021,151,-5100.0,5099.999999999995,HORIBA HORIBA ITALIA SRL,,,,,
9.01.017,RICAVI C/VENDITE ,30/06/2021,150,Giroconto Cessione ,59 / 4 ,04/06/2021, ,5100.0,0.0,HORIBA HORIBA ITALIA SRL,,,,,
9.01.017,RICAVI C/VENDITE ,30/06/2021,229,CESS.COMPENS.REV.CH,60 / 4 ,04/06/2021,152,-5400.0,5400.0,HORIBA HORIBA ITALIA SRL,,,,,
9.01.017,RICAVI C/VENDITE ,30/06/2021,150,Giroconto Cessione ,60 / 4 ,04/06/2021, ,5400.0,0.0,HORIBA HORIBA ITALIA SRL,,,,,
9.01.017,RICAVI C/VENDITE ,30/06/2021,229,CESS.COMPENS.REV.CH,88/PRSP,15/06/2021,153,-205.0,205.0,SIALSR S.I.A.L. SRL,,,,,
9.01.017,RICAVI C/VENDITE ,30/06/2021,150,Giroconto Cessione ,88/PRSP,15/06/2021, ,205.0,0.0,SIALSR S.I.A.L. SRL,,,,,
9.01.017,RICAVI C/VENDITE ,30/06/2021,1229,CESS.COMPENS.REV.CH,93374,15/06/2021,154,323.88,-323.88,FISHER FISHER SCIENTIFIC,,,,,
9.01.017,RICAVI C/VENDITE ,30/06/2021,160,Giroconto Cessione ,93374,15/06/2021, ,-323.88,0.0,FISHER FISHER SCIENTIFIC,,,,,
9.01.017,RICAVI C/VENDITE ,30/06/2021,229,CESS.COMPENS.REV.CH,93463,16/06/2021,155,-1571.25,1571.25,FISHER FISHER SCIENTIFIC,,,,,
9.01.017,RICAVI C/VENDITE ,30/06/2021,150,Giroconto Cessione ,93463,16/06/2021, ,1571.25,0.0,FISHER FISHER SCIENTIFIC,,,,,
9.01.017,RICAVI C/VENDITE ,30/06/2021,229,CESS.COMPENS.REV.CH,62362,03/06/2021,156,-13.02,13.02,BANEMI BPER BANCA S.P.A.,,,,,
9.01.017,RICAVI C/VENDITE ,30/06/2021,150,Giroconto Cessione ,62362,03/06/2021, ,13.02,0.0,BANEMI BPER BANCA S.P.A.,,,,,
9.01.017,RICAVI C/VENDITE ,30/06/2021,229,CESS.COMPENS.REV.CH,FPR19 ,22/06/2021,157,-1410.0,1410.0,GHT EXGHTP s.r.l. in l,,,,,
9.01.017,RICAVI C/VENDITE ,30/06/2021,150,Giroconto Cessione ,FPR19 ,22/06/2021, ,1410.0,0.0,GHT EXGHTP s.r.l. in l,,,,,
9.01.017,RICAVI C/VENDITE ,30/06/2021,229,CESS.COMPENS.REV.CH,92/PRSP,22/06/2021,158,-122.0,122.0,SIALSR S.I.A.L. SRL,,,,,
9.01.017,RICAVI C/VENDITE ,30/06/2021,150,Giroconto Cessione ,92/PRSP,22/06/2021, ,122.0,0.0,SIALSR S.I.A.L. SRL,,,,,
9.01.017,RICAVI C/VENDITE ,30/06/2021,229,CESS.COMPENS.REV.CH,210368,22/06/2021,159,-830.0,830.0,ENCOSR EN.CO. SRL UNIPERS,,,,,
9.01.017,RICAVI C/VENDITE ,30/06/2021,150,Giroconto Cessione ,210368,22/06/2021, ,830.0,0.0,ENCOSR EN.CO. SRL UNIPERS,,,,,
9.01.017,RICAVI C/VENDITE ,30/06/2021,229,CESS.COMPENS.REV.CH,65 / 4 ,21/06/2021,160,-3150.0,3150.0,HORIBA HORIBA ITALIA SRL,,,,,
9.01.017,RICAVI C/VENDITE ,30/06/2021,150,Giroconto Cessione ,65 / 4 ,21/06/2021, ,3150.0,0.0,HORIBA HORIBA ITALIA SRL,,,,,
9.01.017,RICAVI C/VENDITE ,30/06/2021,229,CESS.COMPENS.REV.CH,A5882 ,25/06/2021,161,-2002.0,2002.0,PRODO1 PRODOTTI GIANNI SR,,,,,
9.01.017,RICAVI C/VENDITE ,30/06/2021,150,Giroconto Cessione ,A5882 ,25/06/2021, ,2002.0,0.0,PRODO1 PRODOTTI GIANNI SR,,,,,
9.01.017,RICAVI C/VENDITE ,30/06/2021,229,CESS.COMPENS.REV.CH,2042 A ,30/06/2021,162,-500.0,500.0,DBA D.B.A. ITALIA S.R.,,,,,
9.01.017,RICAVI C/VENDITE ,30/06/2021,150,Giroconto Cessione ,2042 A ,30/06/2021, ,500.0,0.0,DBA D.B.A. ITALIA S.R.,,,,,
9.01.017,RICAVI C/VENDITE ,30/06/2021,229,CESS.COMPENS.REV.CH,1212021,31/05/2021,142,-49.8,49.8,LINKEM LINKEM S.P.A.,,,,,
9.01.017,RICAVI C/VENDITE ,06/07/2021,150,Giroconto Cessione ,1212021,31/05/2021, ,49.8,0.0,LINKEM LINKEM S.P.A.,,,,,
9.01.017,RICAVI C/VENDITE ,30/07/2021,229,CESS.COMPENS.REV.CH,18/SP ,30/06/2021,165,-171.1,171.1,SIDSPA SIDERSAN SPA,,,,,
9.01.017,RICAVI C/VENDITE ,30/07/2021,150,Giroconto Cessione ,18/SP ,30/06/2021, ,171.1,0.0,SIDSPA SIDERSAN SPA,,,,,
9.01.017,RICAVI C/VENDITE ,30/07/2021,229,CESS.COMPENS.REV.CH,55060,30/06/2021,166,-165.0,165.0,VWR VWR INTERNATIONAL,,,,,
9.01.017,RICAVI C/VENDITE ,30/07/2021,150,Giroconto Cessione ,55060,30/06/2021, ,165.0,0.0,VWR VWR INTERNATIONAL,,,,,
9.01.017,RICAVI C/VENDITE ,30/07/2021,229,CESS.COMPENS.REV.CH,068-21 ,30/06/2021,167,-998.0,998.0,DORATE DORA TECNOLOGIE DI,,,,,
9.01.017,RICAVI C/VENDITE ,30/07/2021,150,Giroconto Cessione ,068-21 ,30/06/2021, ,998.0,0.0,DORATE DORA TECNOLOGIE DI,,,,,
9.01.017,RICAVI C/VENDITE ,31/07/2021,229,CESS.COMPENS.REV.CH,607/03 ,30/06/2021,168,-3000.0,3000.0,LGSOLU L & G SOLUTION SRL,,,,,
9.01.017,RICAVI C/VENDITE ,31/07/2021,150,Giroconto Cessione ,607/03 ,30/06/2021, ,3000.0,0.0,LGSOLU L & G SOLUTION SRL,,,,,
9.01.017,RICAVI C/VENDITE ,31/07/2021,229,CESS.COMPENS.REV.CH,99238,30/06/2021,169,-441.62,441.62,SIAD S.I.A.D. S.P.A.,,,,,
9.01.017,RICAVI C/VENDITE ,31/07/2021,150,Giroconto Cessione ,99238,30/06/2021, ,441.62,0.0,SIAD S.I.A.D. S.P.A.,,,,,
9.01.017,RICAVI C/VENDITE ,31/07/2021,229,CESS.COMPENS.REV.CH,469/21 ,02/07/2021,170,-1609.0,1609.0,NOINTE NOVA INFORMATION T,,,,,
9.01.017,RICAVI C/VENDITE ,31/07/2021,150,Giroconto Cessione ,469/21 ,02/07/2021, ,1609.0,0.0,NOINTE NOVA INFORMATION T,,,,,
9.01.017,RICAVI C/VENDITE ,31/07/2021,229,CESS.COMPENS.REV.CH,437,30/06/2021,171,-53.29,53.29,ALGEN ALGEN S.R.L.,,,,,
9.01.017,RICAVI C/VENDITE ,31/07/2021,150,Giroconto Cessione ,437,30/06/2021, ,53.29,0.0,ALGEN ALGEN S.R.L.,,,,,
9.01.017,RICAVI C/VENDITE ,31/07/2021,229,CESS.COMPENS.REV.CH,4907/V1,02/07/2021,172,-21.82,21.82,ELECAM ELETTROCAMPANIA S.,,,,,
9.01.017,RICAVI C/VENDITE ,31/07/2021,150,Giroconto Cessione ,4907/V1,02/07/2021, ,21.82,0.0,ELECAM ELETTROCAMPANIA S.,,,,,
9.01.017,RICAVI C/VENDITE ,31/07/2021,229,CESS.COMPENS.REV.CH,2/001 ,30/06/2021,173,-57918.67,57918.67,TOPIN TOP-IN S.C.A.R.L.,,,,,
9.01.017,RICAVI C/VENDITE ,31/07/2021,150,Giroconto Cessione ,2/001 ,30/06/2021, ,57918.67,0.0,TOPIN TOP-IN S.C.A.R.L.,,,,,
9.01.017,RICAVI C/VENDITE ,31/07/2021,229,CESS.COMPENS.REV.CH,161,05/07/2021,174,-300.0,300.0,NUOQUA NUOVA QUADRIFOGLIO,,,,,
9.01.017,RICAVI C/VENDITE ,31/07/2021,150,Giroconto Cessione ,161,05/07/2021, ,300.0,0.0,NUOQUA NUOVA QUADRIFOGLIO,,,,,
9.01.017,RICAVI C/VENDITE ,31/07/2021,229,CESS.COMPENS.REV.CH,146,06/07/2021,175,-107.27,107.27,GBVEND GB VENDING SRLS,,,,,
9.01.017,RICAVI C/VENDITE ,31/07/2021,150,Giroconto Cessione ,146,06/07/2021, ,107.27,0.0,GBVEND GB VENDING SRLS,,,,,
9.01.017,RICAVI C/VENDITE ,31/07/2021,229,CESS.COMPENS.REV.CH,471,08/07/2021,176,-40.0,40.0,MCSSRL MCS S.R.L.,,,,,
9.01.017,RICAVI C/VENDITE ,31/07/2021,150,Giroconto Cessione ,471,08/07/2021, ,40.0,0.0,MCSSRL MCS S.R.L.,,,,,
9.01.017,RICAVI C/VENDITE ,31/07/2021,229,CESS.COMPENS.REV.CH,78,30/06/2021,177,-665.0,665.0,GENTAU GENTAUR S.R.L. UNI,,,,,
9.01.017,RICAVI C/VENDITE ,31/07/2021,150,Giroconto Cessione ,78,30/06/2021, ,665.0,0.0,GENTAU GENTAUR S.R.L. UNI,,,,,
9.01.017,RICAVI C/VENDITE ,31/07/2021,229,CESS.COMPENS.REV.CH,38,30/06/2021,178,-2320.0,2320.0,REMEDI REMEDIX S.R.L.,,,,,
9.01.017,RICAVI C/VENDITE ,31/07/2021,150,Giroconto Cessione ,38,30/06/2021, ,2320.0,0.0,REMEDI REMEDIX S.R.L.,,,,,
9.01.017,RICAVI C/VENDITE ,31/07/2021,229,CESS.COMPENS.REV.CH,68404,28/06/2021,179,-20826.0,20826.0,AVNET AVNET EMG ITALY S.,,,,,
9.01.017,RICAVI C/VENDITE ,31/07/2021,150,Giroconto Cessione ,68404,28/06/2021, ,20826.0,0.0,AVNET AVNET EMG ITALY S.,,,,,
9.01.017,RICAVI C/VENDITE ,31/07/2021,229,CESS.COMPENS.REV.CH,79,13/07/2021,180,-1800.0,1800.0,START START-UP IMPRESA S,,,,,
9.01.017,RICAVI C/VENDITE ,31/07/2021,150,Giroconto Cessione ,79,13/07/2021, ,1800.0,0.0,START START-UP IMPRESA S,,,,,
9.01.017,RICAVI C/VENDITE ,31/07/2021,229,CESS.COMPENS.REV.CH,627/03 ,09/07/2021,181,-1538.45,1538.45,LGSOLU L & G SOLUTION SRL,,,,,
9.01.017,RICAVI C/VENDITE ,31/07/2021,229,CESS.COMPENS.REV.CH,632/03 ,09/07/2021,182,-1538.45,3076.9,LGSOLU L & G SOLUTION SRL,,,,,
9.01.017,RICAVI C/VENDITE ,31/07/2021,150,Giroconto Cessione ,632/03 ,09/07/2021, ,1538.45,1538.45,LGSOLU L & G SOLUTION SRL,,,,,
9.01.017,RICAVI C/VENDITE ,31/07/2021,229,CESS.COMPENS.REV.CH,634/03 ,09/07/2021,183,-1538.45,3076.9,LGSOLU L & G SOLUTION SRL,,,,,
9.01.017,RICAVI C/VENDITE ,31/07/2021,150,Giroconto Cessione ,634/03 ,09/07/2021, ,1538.45,1538.45,LGSOLU L & G SOLUTION SRL,,,,,
9.01.017,RICAVI C/VENDITE ,31/07/2021,229,CESS.COMPENS.REV.CH,628/03 ,09/07/2021,184,-1561.68,3100.13,LGSOLU L & G SOLUTION SRL,,,,,
9.01.017,RICAVI C/VENDITE ,31/07/2021,150,Giroconto Cessione ,628/03 ,09/07/2021, ,1561.68,1538.45,LGSOLU L & G SOLUTION SRL,,,,,
9.01.017,RICAVI C/VENDITE ,31/07/2021,229,CESS.COMPENS.REV.CH,630/03 ,09/07/2021,185,-1561.68,3100.13,LGSOLU L & G SOLUTION SRL,,,,,
9.01.017,RICAVI C/VENDITE ,31/07/2021,150,Giroconto Cessione ,630/03 ,09/07/2021, ,1561.68,1538.45,LGSOLU L & G SOLUTION SRL,,,,,
9.01.017,RICAVI C/VENDITE ,31/07/2021,229,CESS.COMPENS.REV.CH,629/03 ,09/07/2021,186,-1584.91,3123.36,LGSOLU L & G SOLUTION SRL,,,,,
9.01.017,RICAVI C/VENDITE ,31/07/2021,150,Giroconto Cessione ,629/03 ,09/07/2021, ,1584.91,1538.45,LGSOLU L & G SOLUTION SRL,,,,,
9.01.017,RICAVI C/VENDITE ,31/07/2021,229,CESS.COMPENS.REV.CH,262,30/06/2021,187,-5.05,1543.5,SMARTP SMART PIU' S.R.L.,,,,,
9.01.017,RICAVI C/VENDITE ,31/07/2021,150,Giroconto Cessione ,262,30/06/2021, ,5.05,1538.45,SMARTP SMART PIU' S.R.L.,,,,,
9.01.017,RICAVI C/VENDITE ,31/07/2021,229,CESS.COMPENS.REV.CH,631/03 ,09/07/2021,188,-1561.68,3100.13,LGSOLU L & G SOLUTION SRL,,,,,
9.01.017,RICAVI C/VENDITE ,31/07/2021,150,Giroconto Cessione ,631/03 ,09/07/2021, ,1561.68,1538.45,LGSOLU L & G SOLUTION SRL,,,,,
9.01.017,RICAVI C/VENDITE ,31/07/2021,229,CESS.COMPENS.REV.CH,633/03 ,09/07/2021,189,-1538.45,3076.9,LGSOLU L & G SOLUTION SRL,,,,,
9.01.017,RICAVI C/VENDITE ,31/07/2021,150,Giroconto Cessione ,633/03 ,09/07/2021, ,1538.45,1538.45,LGSOLU L & G SOLUTION SRL,,,,,
9.01.017,RICAVI C/VENDITE ,31/07/2021,229,CESS.COMPENS.REV.CH,79748,02/07/2021,190,-13.02,1551.47,BANEMI BPER BANCA S.P.A.,,,,,
9.01.017,RICAVI C/VENDITE ,31/07/2021,150,Giroconto Cessione ,79748,02/07/2021, ,13.02,1538.45,BANEMI BPER BANCA S.P.A.,,,,,
9.01.017,RICAVI C/VENDITE ,31/07/2021,229,CESS.COMPENS.REV.CH,35/FE ,20/07/2021,191,-21500.0,23038.45,R4I R4I S.R.L.,,,,,
9.01.017,RICAVI C/VENDITE ,31/07/2021,150,Giroconto Cessione ,35/FE ,20/07/2021, ,21500.0,1538.450000000001,R4I R4I S.R.L.,,,,,
9.01.017,RICAVI C/VENDITE ,31/07/2021,229,CESS.COMPENS.REV.CH,26,20/07/2021,192,-400.0,1938.450000000001,ZIEGLE ZIEGLER EMILIO OFF,,,,,
9.01.017,RICAVI C/VENDITE ,31/07/2021,150,Giroconto Cessione ,26,20/07/2021, ,400.0,1538.450000000001,ZIEGLE ZIEGLER EMILIO OFF,,,,,
9.01.017,RICAVI C/VENDITE ,31/07/2021,229,CESS.COMPENS.REV.CH,20011,19/07/2021,193,-6118.0,7656.450000000001,GEHEAL Cytiva Europe GmbH,,,,,
9.01.017,RICAVI C/VENDITE ,31/07/2021,150,Giroconto Cessione ,20011,19/07/2021, ,6118.0,1538.450000000001,GEHEAL Cytiva Europe GmbH,,,,,
9.01.017,RICAVI C/VENDITE ,31/07/2021,229,CESS.COMPENS.REV.CH,34187,19/07/2021,194,-267.0,1805.450000000001,RS RS COMPONENTS S.r.,,,,,
9.01.017,RICAVI C/VENDITE ,31/07/2021,150,Giroconto Cessione ,34187,19/07/2021, ,267.0,1538.450000000001,RS RS COMPONENTS S.r.,,,,,
9.01.017,RICAVI C/VENDITE ,31/07/2021,229,CESS.COMPENS.REV.CH,20033,21/07/2021,195,-387.6,1926.050000000001,GEHEAL Cytiva Europe GmbH,,,,,
9.01.017,RICAVI C/VENDITE ,31/07/2021,150,Giroconto Cessione ,20033,21/07/2021, ,387.6,1538.450000000001,GEHEAL Cytiva Europe GmbH,,,,,
9.01.017,RICAVI C/VENDITE ,31/07/2021,229,CESS.COMPENS.REV.CH,2079,22/07/2021,196,-685.0,2223.450000000001,NOTGER NOTARBARTOLO & GER,,,,,
9.01.017,RICAVI C/VENDITE ,31/07/2021,150,Giroconto Cessione ,2079,22/07/2021, ,685.0,1538.450000000001,NOTGER NOTARBARTOLO & GER,,,,,
9.01.017,RICAVI C/VENDITE ,31/07/2021,229,CESS.COMPENS.REV.CH,2058,15/07/2021,197,-54117.0,55655.45,TECON TECON,,,,,
9.01.017,RICAVI C/VENDITE ,31/07/2021,150,Giroconto Cessione ,2058,15/07/2021, ,54117.0,1538.449999999997,TECON TECON,,,,,
9.01.017,RICAVI C/VENDITE ,31/07/2021,229,CESS.COMPENS.REV.CH,3668,27/07/2021,198,-399.6,1938.049999999997,SILCAM Silcam Italia S.r.,,,,,
9.01.017,RICAVI C/VENDITE ,31/07/2021,150,Giroconto Cessione ,3668,27/07/2021, ,399.6,1538.449999999997,SILCAM Silcam Italia S.r.,,,,,
9.01.017,RICAVI C/VENDITE ,31/07/2021,229,CESS.COMPENS.REV.CH,1569,23/07/2021,199,-6433.0,7971.449999999997,EOSSRL EOS SRL ELECTRO OP,,,,,
9.01.017,RICAVI C/VENDITE ,31/07/2021,150,Giroconto Cessione ,1569,23/07/2021, ,6433.0,1538.449999999997,EOSSRL EOS SRL ELECTRO OP,,,,,
9.01.017,RICAVI C/VENDITE ,31/07/2021,150,Giroconto Cessione ,627/03 ,09/07/2021, ,1538.45,-2.955857780762017e-12,LGSOLU L & G SOLUTION SRL,,,,,
9.01.017,RICAVI C/VENDITE ,31/07/2021,229,CESS.COMPENS.REV.CH,51125,22/07/2021,200,-533.85,533.8499999999971,VODAFO VODAFONE ITALIA S.,,,,,
9.01.017,RICAVI C/VENDITE ,31/07/2021,150,Giroconto Cessione ,51125,22/07/2021, ,533.85,-2.955857780762017e-12,VODAFO VODAFONE ITALIA S.,,,,,
9.01.017,RICAVI C/VENDITE ,31/07/2021,229,CESS.COMPENS.REV.CH,741/03 ,27/07/2021,201,-1631.37,1631.369999999997,LGSOLU L & G SOLUTION SRL,,,,,
9.01.017,RICAVI C/VENDITE ,31/07/2021,150,Giroconto Cessione ,741/03 ,27/07/2021, ,1631.37,-2.955857780762017e-12,LGSOLU L & G SOLUTION SRL,,,,,
9.01.017,RICAVI C/VENDITE ,31/07/2021,229,CESS.COMPENS.REV.CH,M46725 ,27/07/2021,202,-1661.91,1661.909999999997,EDENRE EDENRED ITALIA Srl,,,,,
9.01.017,RICAVI C/VENDITE ,31/07/2021,150,Giroconto cessione , ,31/07/2021, ,1661.91,-2.955857780762017e-12,EDENRE EDENRED ITALIA Srl,,,,,
9.01.017,RICAVI C/VENDITE ,31/07/2021,229,CESS.COMPENS.REV.CH,56/PA21,28/07/2021,203,-6200.0,6199.999999999997,HARDSO Hard & Soft House,,,,,
9.01.017,RICAVI C/VENDITE ,31/07/2021,150,Giroconto Cessione ,56/PA21,28/07/2021, ,6200.0,0.0,HARDSO Hard & Soft House,,,,,
9.01.017,RICAVI C/VENDITE ,31/07/2021,229,CESS.COMPENS.REV.CH,84,30/07/2021,204,-600.0,600.0,PAONE LEGATORIA E SERIGR,,,,,
9.01.017,RICAVI C/VENDITE ,31/07/2021,150,Giroconto Cessione ,84,30/07/2021, ,600.0,0.0,PAONE LEGATORIA E SERIGR,,,,,
9.01.017,RICAVI C/VENDITE ,31/08/2021,229,CESS.COMPENS.REV.CH,FPR191 ,31/07/2021,211,-200.0,200.0,NUOQUA NUOVA QUADRIFOGLIO,,,,,
9.01.017,RICAVI C/VENDITE ,31/08/2021,150,Giroconto Cessione ,FPR191 ,31/07/2021, ,200.0,0.0,NUOQUA NUOVA QUADRIFOGLIO,,,,,
9.01.017,RICAVI C/VENDITE ,31/08/2021,229,CESS.COMPENS.REV.CH,8883/V1,30/07/2021,212,-186.7,186.7,ELECAM ELETTROCAMPANIA S.,,,,,
9.01.017,RICAVI C/VENDITE ,31/08/2021,150,Giroconto Cessione ,8883/V1,30/07/2021, ,186.7,0.0,ELECAM ELETTROCAMPANIA S.,,,,,
9.01.017,RICAVI C/VENDITE ,31/08/2021,229,CESS.COMPENS.REV.CH,21/SP ,31/07/2021,213,-120.55,120.55,SIDSPA SIDERSAN SPA,,,,,
9.01.017,RICAVI C/VENDITE ,31/08/2021,150,Giroconto Cessione ,21/SP ,31/07/2021, ,120.55,0.0,SIDSPA SIDERSAN SPA,,,,,
9.01.017,RICAVI C/VENDITE ,31/08/2021,229,CESS.COMPENS.REV.CH,522,31/07/2021,214,-15.84,15.84,ALGEN ALGEN S.R.L.,,,,,
9.01.017,RICAVI C/VENDITE ,31/08/2021,150,Giroconto Cessione ,522,31/07/2021, ,15.84,0.0,ALGEN ALGEN S.R.L.,,,,,
9.01.017,RICAVI C/VENDITE ,31/08/2021,229,CESS.COMPENS.REV.CH,293114,04/08/2021,215,-283.0,283.0,SIGMAA SIGMA ALDRICH S.R.,,,,,
9.01.017,RICAVI C/VENDITE ,31/08/2021,150,Giroconto Cessione ,293114,04/08/2021, ,283.0,0.0,SIGMAA SIGMA ALDRICH S.R.,,,,,
9.01.017,RICAVI C/VENDITE ,31/08/2021,160,Giroconto Cessione ,858/R1 ,03/08/2021, ,-186.7,186.7,ELECAM ELETTROCAMPANIA S.,,,,,
9.01.017,RICAVI C/VENDITE ,31/08/2021,229,CESS.COMPENS.REV.CH,23833,01/08/2021,217,-49.8,236.5,LINKEM LINKEM S.P.A.,,,,,
9.01.017,RICAVI C/VENDITE ,31/08/2021,150,Giroconto Cessione ,23833,01/08/2021, ,49.8,186.7,LINKEM LINKEM S.P.A.,,,,,
9.01.017,RICAVI C/VENDITE ,31/08/2021,229,CESS.COMPENS.REV.CH,29339,03/08/2021,218,-186.7,373.4,ELECAM ELETTROCAMPANIA S.,,,,,
9.01.017,RICAVI C/VENDITE ,31/08/2021,1229,CESS.COMPENS.REV.CH,858/R1 ,03/08/2021,216,186.7,186.7,ELECAM ELETTROCAMPANIA S.,,,,,
9.01.017,RICAVI C/VENDITE ,31/08/2021,150,Giroconto Cessione ,29339,03/08/2021, ,186.7,0.0,ELECAM ELETTROCAMPANIA S.,,,,,
9.01.017,RICAVI C/VENDITE ,31/08/2021,229,CESS.COMPENS.REV.CH,204923,09/08/2021,219,-22595.45,22595.45,PERKIN PerkinElmer Italia,,,,,
9.01.017,RICAVI C/VENDITE ,31/08/2021,150,Giroconto Cessione ,204923,09/08/2021, ,22595.45,0.0,PERKIN PerkinElmer Italia,,,,,
9.01.017,RICAVI C/VENDITE ,31/08/2021,229,CESS.COMPENS.REV.CH,104,31/07/2021,220,-6800.0,6800.0,DATABO DATABOOZ ITALIA S.,,,,,
9.01.017,RICAVI C/VENDITE ,31/08/2021,150,Giroconto Cessione ,104,31/07/2021, ,6800.0,0.0,DATABO DATABOOZ ITALIA S.,,,,,
9.01.017,RICAVI C/VENDITE ,31/08/2021,229,CESS.COMPENS.REV.CH,287,31/07/2021,221,-31.31,31.31,SMARTP SMART PIU' S.R.L.,,,,,
9.01.017,RICAVI C/VENDITE ,31/08/2021,150,Giroconto Cessione ,287,31/07/2021, ,31.31,0.0,SMARTP SMART PIU' S.R.L.,,,,,
9.01.017,RICAVI C/VENDITE ,31/08/2021,229,CESS.COMPENS.REV.CH,96425,16/08/2021,222,-389.2,389.2,SIGMAA SIGMA ALDRICH S.R.,,,,,
9.01.017,RICAVI C/VENDITE ,31/08/2021,150,Giroconto Cessione ,96425,16/08/2021, ,389.2,0.0,SIGMAA SIGMA ALDRICH S.R.,,,,,
9.01.017,RICAVI C/VENDITE ,31/08/2021,229,CESS.COMPENS.REV.CH,99165,04/08/2021,223,-13.02,13.02,BANEMI BPER BANCA S.P.A.,,,,,
9.01.017,RICAVI C/VENDITE ,31/08/2021,150,Giroconto Cessione ,99165,04/08/2021, ,13.02,0.0,BANEMI BPER BANCA S.P.A.,,,,,
9.01.017,RICAVI C/VENDITE ,23/09/2021,229,CESS.COMPENS.REV.CH,116,02/09/2021,225,-313.0,313.0,SIALSR S.I.A.L. SRL,,,,,
9.01.017,RICAVI C/VENDITE ,23/09/2021,150,Giroconto Cessione ,116,02/09/2021, ,313.0,0.0,SIALSR S.I.A.L. SRL,,,,,
9.01.017,RICAVI C/VENDITE ,23/09/2021,229,CESS.COMPENS.REV.CH,FPR23 ,06/09/2021,226,-2975.0,2975.0,GHT EXGHTP s.r.l. in l,,,,,
9.01.017,RICAVI C/VENDITE ,23/09/2021,150,Giroconto Cessione ,FPR23 ,06/09/2021, ,2975.0,0.0,GHT EXGHTP s.r.l. in l,,,,,
9.01.017,RICAVI C/VENDITE ,23/09/2021,229,CESS.COMPENS.REV.CH,5\PA/24,07/09/2021,227,-113.1,113.1,CRCSTO C.R.C. STORE S.R.L,,,,,
9.01.017,RICAVI C/VENDITE ,23/09/2021,150,Giroconto Cessione ,5\PA/24,07/09/2021, ,113.1,0.0,CRCSTO C.R.C. STORE S.R.L,,,,,
9.01.017,RICAVI C/VENDITE ,23/09/2021,229,CESS.COMPENS.REV.CH,326,10/09/2021,228,-440.0,440.0,SAFET2 SAFETY-NATURE S.A.,,,,,
9.01.017,RICAVI C/VENDITE ,23/09/2021,150,Giroconto Cessione ,326,10/09/2021, ,440.0,0.0,SAFET2 SAFETY-NATURE S.A.,,,,,
9.01.017,RICAVI C/VENDITE ,23/09/2021,229,CESS.COMPENS.REV.CH,A8091 ,08/09/2021,229,-640.0,640.0,PRODO1 PRODOTTI GIANNI SR,,,,,
9.01.017,RICAVI C/VENDITE ,23/09/2021,150,Giroconto Cessione ,A8091 ,08/09/2021, ,640.0,0.0,PRODO1 PRODOTTI GIANNI SR,,,,,
9.01.017,RICAVI C/VENDITE ,23/09/2021,229,CESS.COMPENS.REV.CH,3516/V1,13/09/2021,230,-14.58,14.58,ELECAM ELETTROCAMPANIA S.,,,,,
9.01.017,RICAVI C/VENDITE ,23/09/2021,150,Giroconto Cessione ,3516/V1,13/09/2021, ,14.58,0.0,ELECAM ELETTROCAMPANIA S.,,,,,
9.01.017,RICAVI C/VENDITE ,23/09/2021,229,CESS.COMPENS.REV.CH,918776,07/09/2021,231,-13.02,13.02,BANEMI BPER BANCA S.P.A.,,,,,
9.01.017,RICAVI C/VENDITE ,23/09/2021,150,Giroconto Cessione ,918776,07/09/2021, ,13.02,0.0,BANEMI BPER BANCA S.P.A.,,,,,
9.01.017,RICAVI C/VENDITE ,23/09/2021,229,CESS.COMPENS.REV.CH,131,21/09/2021,232,-837.0,837.0,SIALSR S.I.A.L. SRL,,,,,
9.01.017,RICAVI C/VENDITE ,23/09/2021,150,Giroconto Cessione ,131,21/09/2021, ,837.0,0.0,SIALSR S.I.A.L. SRL,,,,,
9.01.017,RICAVI C/VENDITE ,30/09/2021,150,Giroconto Cessione ,88667,22/09/2021, ,515.8,-515.8,VODAFO VODAFONE ITALIA S.,,,,,
9.01.017,RICAVI C/VENDITE ,30/09/2021,229,CESS.COMPENS.REV.CH,88667,22/09/2021,233,-515.8,0.0,VODAFO VODAFONE ITALIA S.,,,,,
9.01.017,RICAVI C/VENDITE ,30/09/2021,229,CESS.COMPENS.REV.CH,570,23/09/2021,234,-189.8,189.8,PERMAX PERMAX SRL,,,,,
9.01.017,RICAVI C/VENDITE ,30/09/2021,150,Giroconto Cessione ,570,23/09/2021, ,189.8,0.0,PERMAX PERMAX SRL,,,,,
9.01.017,RICAVI C/VENDITE ,30/09/2021,229,CESS.COMPENS.REV.CH,1073,22/09/2021,235,-15.0,15.0,DELLIC GRAFICHE IUORIO S.,,,,,
9.01.017,RICAVI C/VENDITE ,30/09/2021,229,CESS.COMPENS.REV.CH,2611,17/09/2021,236,-7365.0,7380.0,TECON TECON,,,,,
9.01.017,RICAVI C/VENDITE ,30/09/2021,150,Giroconto Cessione ,2611,17/09/2021, ,7365.0,15.0,TECON TECON,,,,,
9.01.017,RICAVI C/VENDITE ,30/09/2021,229,CESS.COMPENS.REV.CH,FPR232 ,24/09/2021,237,-350.0,365.0,NUOQUA NUOVA QUADRIFOGLIO,,,,,
9.01.017,RICAVI C/VENDITE ,30/09/2021,150,Giroconto Cessione ,FPR232 ,24/09/2021, ,350.0,15.0,NUOQUA NUOVA QUADRIFOGLIO,,,,,
9.01.017,RICAVI C/VENDITE ,30/09/2021,229,CESS.COMPENS.REV.CH,20409,22/09/2021,238,-1330.0,1345.0,GEHEAL Cytiva Europe GmbH,,,,,
9.01.017,RICAVI C/VENDITE ,30/09/2021,150,Giroconto Cessione ,20409,22/09/2021, ,1330.0,15.0,GEHEAL Cytiva Europe GmbH,,,,,
9.01.017,RICAVI C/VENDITE ,30/09/2021,229,CESS.COMPENS.REV.CH,FPR3/21,29/09/2021,239,-22800.0,22815.0,EFAIST EFAISTOS S.R.L.,,,,,
9.01.017,RICAVI C/VENDITE ,30/09/2021,150,Giroconto Cessione ,FPR3/21,29/09/2021, ,22800.0,15.0,EFAIST EFAISTOS S.R.L.,,,,,
9.01.017,RICAVI C/VENDITE ,30/09/2021,229,CESS.COMPENS.REV.CH,22522,28/09/2021,240,-689674.32,689689.32,THERM1 THERMO FISHER SCIE,,,,,
9.01.017,RICAVI C/VENDITE ,30/09/2021,150,Giroconto Cessione ,22522,28/09/2021, ,689674.32,15.0,THERM1 THERMO FISHER SCIE,,,,,
9.01.017,RICAVI C/VENDITE ,30/09/2021,229,CESS.COMPENS.REV.CH,4020474,29/09/2021,241,-475.0,490.0,GEHEAL Cytiva Europe GmbH,,,,,
9.01.017,RICAVI C/VENDITE ,30/09/2021,150,Giroconto Cessione ,1073,22/09/2021, ,15.0,475.0,DELLIC GRAFICHE IUORIO S.,,,,,
9.01.017,RICAVI C/VENDITE ,04/12/2021,150,Giroconto Cessione ,4020474,29/09/2021, ,475.0,0.0,GEHEAL Cytiva Europe GmbH,,,,,
9.01.017,RICAVI C/VENDITE ,31/10/2021,229,CESS.COMPENS.REV.CH,205801,01/10/2021,244,-214680.75,214680.75,PERKIN PerkinElmer Italia,,,,,
9.01.017,RICAVI C/VENDITE ,31/10/2021,150,Giroconto Cessione ,205801,01/10/2021, ,214680.75,0.0,PERKIN PerkinElmer Italia,,,,,
9.01.017,RICAVI C/VENDITE ,31/10/2021,229,CESS.COMPENS.REV.CH,921/03 ,30/09/2021,245,-1584.91,1584.91,LGSOLU L & G SOLUTION SRL,,,,,
9.01.017,RICAVI C/VENDITE ,31/10/2021,150,Giroconto Cessione ,921/03 ,30/09/2021, ,1584.91,0.0,LGSOLU L & G SOLUTION SRL,,,,,
9.01.017,RICAVI C/VENDITE ,31/10/2021,229,CESS.COMPENS.REV.CH,920/03 ,30/09/2021,246,-1584.91,1584.91,LGSOLU L & G SOLUTION SRL,,,,,
9.01.017,RICAVI C/VENDITE ,31/10/2021,150,Giroconto Cessione ,920/03 ,30/09/2021, ,1584.91,0.0,LGSOLU L & G SOLUTION SRL,,,,,
9.01.017,RICAVI C/VENDITE ,31/10/2021,229,CESS.COMPENS.REV.CH,919/03 ,30/09/2021,247,-1584.91,1584.91,LGSOLU L & G SOLUTION SRL,,,,,
9.01.017,RICAVI C/VENDITE ,31/10/2021,150,Giroconto Cessione ,919/03 ,30/09/2021, ,1584.91,0.0,LGSOLU L & G SOLUTION SRL,,,,,
9.01.017,RICAVI C/VENDITE ,31/10/2021,229,CESS.COMPENS.REV.CH,922/03 ,30/09/2021,248,-1584.91,1584.91,LGSOLU L & G SOLUTION SRL,,,,,
9.01.017,RICAVI C/VENDITE ,31/10/2021,150,Giroconto Cessione ,922/03 ,30/09/2021, ,1584.91,0.0,LGSOLU L & G SOLUTION SRL,,,,,
9.01.017,RICAVI C/VENDITE ,31/10/2021,229,CESS.COMPENS.REV.CH,26/SP ,30/09/2021,249,-56.67,56.67,SIDSPA SIDERSAN SPA,,,,,
9.01.017,RICAVI C/VENDITE ,31/10/2021,150,Giroconto Cessione ,26/SP ,30/09/2021, ,56.67,0.0,SIDSPA SIDERSAN SPA,,,,,
9.01.017,RICAVI C/VENDITE ,31/10/2021,229,CESS.COMPENS.REV.CH,5779,30/09/2021,250,-936.0,936.0,PERKIN PerkinElmer Italia,,,,,
9.01.017,RICAVI C/VENDITE ,31/10/2021,150,Giroconto Cessione ,5779,30/09/2021, ,936.0,0.0,PERKIN PerkinElmer Italia,,,,,
9.01.017,RICAVI C/VENDITE ,31/10/2021,229,CESS.COMPENS.REV.CH,622,30/09/2021,251,-13.94,13.94,ALGEN ALGEN S.R.L.,,,,,
9.01.017,RICAVI C/VENDITE ,31/10/2021,150,Giroconto Cessione ,622,30/09/2021, ,13.94,0.0,ALGEN ALGEN S.R.L.,,,,,
9.01.017,RICAVI C/VENDITE ,31/10/2021,229,CESS.COMPENS.REV.CH,67/2021,30/09/2021,252,-10.0,10.0,WORLDT WORLD TRAVEL BOUTI,,,,,
9.01.017,RICAVI C/VENDITE ,31/10/2021,150,Giroconto Cessione ,67/2021,30/09/2021, ,10.0,0.0,WORLDT WORLD TRAVEL BOUTI,,,,,
9.01.017,RICAVI C/VENDITE ,31/10/2021,229,CESS.COMPENS.REV.CH,936/03 ,30/09/2021,253,-1561.68,1561.68,LGSOLU L & G SOLUTION SRL,,,,,
9.01.017,RICAVI C/VENDITE ,31/10/2021,150,Giroconto Cessione ,936/03 ,30/09/2021, ,1561.68,0.0,LGSOLU L & G SOLUTION SRL,,,,,
9.01.017,RICAVI C/VENDITE ,31/10/2021,229,CESS.COMPENS.REV.CH,935/03 ,30/09/2021,254,-1584.91,1584.91,LGSOLU L & G SOLUTION SRL,,,,,
9.01.017,RICAVI C/VENDITE ,31/10/2021,150,Giroconto Cessione ,935/03 ,30/09/2021, ,1584.91,0.0,LGSOLU L & G SOLUTION SRL,,,,,
9.01.017,RICAVI C/VENDITE ,31/10/2021,229,CESS.COMPENS.REV.CH,932/03 ,30/09/2021,255,-1584.91,1584.91,LGSOLU L & G SOLUTION SRL,,,,,
9.01.017,RICAVI C/VENDITE ,31/10/2021,150,Giroconto Cessione ,932/03 ,30/09/2021, ,1584.91,0.0,LGSOLU L & G SOLUTION SRL,,,,,
9.01.017,RICAVI C/VENDITE ,31/10/2021,229,CESS.COMPENS.REV.CH,933/03 ,30/09/2021,256,-1584.91,1584.91,LGSOLU L & G SOLUTION SRL,,,,,
9.01.017,RICAVI C/VENDITE ,31/10/2021,150,Giroconto Cessione ,933/03 ,30/09/2021, ,1584.91,0.0,LGSOLU L & G SOLUTION SRL,,,,,
9.01.017,RICAVI C/VENDITE ,31/10/2021,229,CESS.COMPENS.REV.CH,3252,30/09/2021,257,-14.99,14.99,TECRAI Aruba S.p.A.,,,,,
9.01.017,RICAVI C/VENDITE ,31/10/2021,150,Giroconto Cessione ,3252,30/09/2021, ,14.99,0.0,TECRAI Aruba S.p.A.,,,,,
9.01.017,RICAVI C/VENDITE ,31/10/2021,1229,CESS.COMPENS.REV.CH,69/2021,05/10/2021,258,10.0,-10.0,WORLDT WORLD TRAVEL BOUTI,,,,,
9.01.017,RICAVI C/VENDITE ,31/10/2021,160,Giroconto Cessione ,69/2021,05/10/2021, ,-10.0,0.0,WORLDT WORLD TRAVEL BOUTI,,,,,
9.01.017,RICAVI C/VENDITE ,31/10/2021,229,CESS.COMPENS.REV.CH,71/2021,05/10/2021,259,-10.0,10.0,WORLDT WORLD TRAVEL BOUTI,,,,,
9.01.017,RICAVI C/VENDITE ,31/10/2021,150,Giroconto Cessione ,71/2021,05/10/2021, ,10.0,0.0,WORLDT WORLD TRAVEL BOUTI,,,,,
9.01.017,RICAVI C/VENDITE ,31/10/2021,229,CESS.COMPENS.REV.CH,1149654,30/09/2021,260,-406.25,406.25,SIAD S.I.A.D. S.P.A.,,,,,
9.01.017,RICAVI C/VENDITE ,31/10/2021,150,Giroconto Cessione ,1149654,30/09/2021, ,406.25,0.0,SIAD S.I.A.D. S.P.A.,,,,,
9.01.017,RICAVI C/VENDITE ,31/10/2021,229,CESS.COMPENS.REV.CH,20504,30/09/2021,261,-95.0,95.0,GEHEAL Cytiva Europe GmbH,,,,,
9.01.017,RICAVI C/VENDITE ,31/10/2021,150,Giroconto Cessione ,20504,30/09/2021, ,95.0,0.0,GEHEAL Cytiva Europe GmbH,,,,,
9.01.017,RICAVI C/VENDITE ,31/10/2021,229,CESS.COMPENS.REV.CH,40960,29/09/2021,262,-49.8,49.8,LINKEM LINKEM S.P.A.,,,,,
9.01.017,RICAVI C/VENDITE ,31/10/2021,150,Giroconto Cessione ,40960,29/09/2021, ,49.8,0.0,LINKEM LINKEM S.P.A.,,,,,
9.01.017,RICAVI C/VENDITE ,31/10/2021,229,CESS.COMPENS.REV.CH,19515,06/10/2021,263,-342.81,342.81,SIGMAA SIGMA ALDRICH S.R.,,,,,
9.01.017,RICAVI C/VENDITE ,31/10/2021,150,Giroconto Cessione ,19515,06/10/2021, ,342.81,0.0,SIGMAA SIGMA ALDRICH S.R.,,,,,
9.01.017,RICAVI C/VENDITE ,31/10/2021,229,CESS.COMPENS.REV.CH,5202740,05/10/2021,264,-28.14,28.14,FARNEL FARNEL ITALIA S.R.,,,,,
9.01.017,RICAVI C/VENDITE ,31/10/2021,150,Giroconto Cessione ,5202740,05/10/2021, ,28.14,0.0,FARNEL FARNEL ITALIA S.R.,,,,,
9.01.017,RICAVI C/VENDITE ,31/10/2021,229,CESS.COMPENS.REV.CH,100753,06/10/2021,265,-360.08,360.08,FISHER FISHER SCIENTIFIC,,,,,
9.01.017,RICAVI C/VENDITE ,31/10/2021,229,CESS.COMPENS.REV.CH,20543,06/10/2021,266,-461.7,821.78,GEHEAL Cytiva Europe GmbH,,,,,
9.01.017,RICAVI C/VENDITE ,31/10/2021,150,Giroconto Cessione ,20543,06/10/2021, ,461.7,360.08,GEHEAL Cytiva Europe GmbH,,,,,
9.01.017,RICAVI C/VENDITE ,31/10/2021,229,CESS.COMPENS.REV.CH,FPR70 ,07/10/2021,267,-10886.01,11246.09,ICTSUD CENTRO DI COMPETEN,,,,,
9.01.017,RICAVI C/VENDITE ,31/10/2021,150,Giroconto Cessione ,FPR70 ,07/10/2021, ,10886.01,360.0799999999999,ICTSUD CENTRO DI COMPETEN,,,,,
9.01.017,RICAVI C/VENDITE ,31/10/2021,229,CESS.COMPENS.REV.CH,2200009,08/10/2021,268,-12042.0,12402.08,SGRRIC SGR Ricerche S.r.l,,,,,
9.01.017,RICAVI C/VENDITE ,31/10/2021,150,Giroconto Cessione ,2200009,08/10/2021, ,12042.0,360.0799999999999,SGRRIC SGR Ricerche S.r.l,,,,,
9.01.017,RICAVI C/VENDITE ,31/10/2021,229,CESS.COMPENS.REV.CH,453,01/10/2021,269,-226.0,586.0799999999999,TECECO TECNO-ECO S.R.L.,,,,,
9.01.017,RICAVI C/VENDITE ,31/10/2021,150,Giroconto Cessione ,453,01/10/2021, ,226.0,360.0799999999999,TECECO TECNO-ECO S.R.L.,,,,,
9.01.017,RICAVI C/VENDITE ,31/10/2021,229,CESS.COMPENS.REV.CH,1437,07/10/2021,270,-1718.74,2078.82,SYSPAC SYSPACK COMPUTER I,,,,,
9.01.017,RICAVI C/VENDITE ,31/10/2021,229,CESS.COMPENS.REV.CH,24032,15/10/2021,271,-1323.0,3401.82,SIGMAA SIGMA ALDRICH S.R.,,,,,
9.01.017,RICAVI C/VENDITE ,31/10/2021,150,Giroconto Cessione ,24032,15/10/2021, ,1323.0,2078.82,SIGMAA SIGMA ALDRICH S.R.,,,,,
9.01.017,RICAVI C/VENDITE ,31/10/2021,229,CESS.COMPENS.REV.CH,41200,04/10/2021,272,-13.02,2091.84,BANEMI BPER BANCA S.P.A.,,,,,
9.01.017,RICAVI C/VENDITE ,31/10/2021,150,Giroconto Cessione ,41200,04/10/2021, ,13.02,2078.82,BANEMI BPER BANCA S.P.A.,,,,,
9.01.017,RICAVI C/VENDITE ,31/10/2021,229,CESS.COMPENS.REV.CH,217195,16/10/2021,273,-176.55,2255.37,AMAEU Amazon EU S.a r.l.,,,,,
9.01.017,RICAVI C/VENDITE ,31/10/2021,150,Giroconto Cessione ,217195,16/10/2021, ,176.55,2078.82,AMAEU Amazon EU S.a r.l.,,,,,
9.01.017,RICAVI C/VENDITE ,31/10/2021,229,CESS.COMPENS.REV.CH,100639,05/10/2021,274,-56.2,2135.02,FISHER FISHER SCIENTIFIC,,,,,
9.01.017,RICAVI C/VENDITE ,31/10/2021,150,Giroconto Cessione ,100639,05/10/2021, ,56.2,2078.82,FISHER FISHER SCIENTIFIC,,,,,
9.01.017,RICAVI C/VENDITE ,31/10/2021,229,CESS.COMPENS.REV.CH,102393,19/10/2021,275,-1900.0,3978.82,ASACER ASACERT ASSESSMENT,,,,,
9.01.017,RICAVI C/VENDITE ,31/10/2021,150,Giroconto Cessione ,102393,19/10/2021, ,1900.0,2078.82,ASACER ASACERT ASSESSMENT,,,,,
9.01.017,RICAVI C/VENDITE ,31/10/2021,1229,CESS.COMPENS.REV.CH,4020628,18/10/2021,276,6118.0,-4039.18,GEHEAL Cytiva Europe GmbH,,,,,
9.01.017,RICAVI C/VENDITE ,31/10/2021,160,Giroconto Cessione ,4020628,18/10/2021, ,-6118.0,2078.82,GEHEAL Cytiva Europe GmbH,,,,,
9.01.017,RICAVI C/VENDITE ,31/10/2021,1229,CESS.COMPENS.REV.CH,20629,18/10/2021,277,387.6,1691.22,GEHEAL Cytiva Europe GmbH,,,,,
9.01.017,RICAVI C/VENDITE ,31/10/2021,160,Giroconto Cessione ,20629,18/10/2021, ,-387.6,2078.82,GEHEAL Cytiva Europe GmbH,,,,,
9.01.017,RICAVI C/VENDITE ,31/10/2021,1229,CESS.COMPENS.REV.CH,20630,18/10/2021,278,1330.0,748.8199999999997,GEHEAL Cytiva Europe GmbH,,,,,
9.01.017,RICAVI C/VENDITE ,31/10/2021,160,Giroconto Cessione ,20630,18/10/2021, ,-1330.0,2078.82,GEHEAL Cytiva Europe GmbH,,,,,
9.01.017,RICAVI C/VENDITE ,31/10/2021,1229,CESS.COMPENS.REV.CH,20631,18/10/2021,279,475.0,1603.82,GEHEAL Cytiva Europe GmbH,,,,,
9.01.017,RICAVI C/VENDITE ,31/10/2021,160,Giroconto Cessione ,20631,18/10/2021, ,-475.0,2078.82,GEHEAL Cytiva Europe GmbH,,,,,
9.01.017,RICAVI C/VENDITE ,31/10/2021,1229,CESS.COMPENS.REV.CH,20632,18/10/2021,280,95.0,1983.82,GEHEAL Cytiva Europe GmbH,,,,,
9.01.017,RICAVI C/VENDITE ,31/10/2021,160,Giroconto Cessione ,20632,18/10/2021, ,-95.0,2078.82,GEHEAL Cytiva Europe GmbH,,,,,
9.01.017,RICAVI C/VENDITE ,31/10/2021,1229,CESS.COMPENS.REV.CH,20633,18/10/2021,281,461.7,1617.12,GEHEAL Cytiva Europe GmbH,,,,,
9.01.017,RICAVI C/VENDITE ,31/10/2021,160,Giroconto Cessione ,20633,18/10/2021, ,-461.7,2078.82,GEHEAL Cytiva Europe GmbH,,,,,
9.01.017,RICAVI C/VENDITE ,31/10/2021,229,CESS.COMPENS.REV.CH,20640,18/10/2021,282,-4152.0,6230.82,GEHEAL Cytiva Europe GmbH,,,,,
9.01.017,RICAVI C/VENDITE ,31/10/2021,150,Giroconto Cessione ,20640,18/10/2021, ,4152.0,2078.82,GEHEAL Cytiva Europe GmbH,,,,,
9.01.017,RICAVI C/VENDITE ,31/10/2021,229,CESS.COMPENS.REV.CH,20647,18/10/2021,283,-8867.3,10946.12,GEHEAL Cytiva Europe GmbH,,,,,
9.01.017,RICAVI C/VENDITE ,31/10/2021,150,Giroconto Cessione ,20647,18/10/2021, ,8867.3,2078.82,GEHEAL Cytiva Europe GmbH,,,,,
9.01.017,RICAVI C/VENDITE ,31/10/2021,229,CESS.COMPENS.REV.CH,25568,19/10/2021,284,-1377.0,3455.82,SIGMAA SIGMA ALDRICH S.R.,,,,,
9.01.017,RICAVI C/VENDITE ,31/10/2021,150,Giroconto Cessione ,25568,19/10/2021, ,1377.0,2078.82,SIGMAA SIGMA ALDRICH S.R.,,,,,
9.01.017,RICAVI C/VENDITE ,31/10/2021,150,Giroconto Cessione ,1437,07/10/2021, ,1718.74,360.0799999999997,SYSPAC SYSPACK COMPUTER I,,,,,
9.01.017,RICAVI C/VENDITE ,31/10/2021,229,CESS.COMPENS.REV.CH,00977/0,15/10/2021,285,-1260.22,1620.3,DELTEK DELTEK SRL,,,,,
9.01.017,RICAVI C/VENDITE ,31/10/2021,150,Giroconto Cessione ,00977/0,15/10/2021, ,1260.22,360.0799999999997,DELTEK DELTEK SRL,,,,,
9.01.017,RICAVI C/VENDITE ,31/10/2021,229,CESS.COMPENS.REV.CH,3538,22/10/2021,286,-11.99,372.0699999999997,TECRAI Aruba S.p.A.,,,,,
9.01.017,RICAVI C/VENDITE ,31/10/2021,150,Giroconto Cessione ,3538,22/10/2021, ,11.99,360.0799999999997,TECRAI Aruba S.p.A.,,,,,
9.01.017,RICAVI C/VENDITE ,31/10/2021,229,CESS.COMPENS.REV.CH,102360,25/10/2021,288,-184320.0,184680.08,BEANTE Beantech Srl,,,,,
9.01.017,RICAVI C/VENDITE ,31/10/2021,150,Giroconto Cessione ,102360,25/10/2021, ,184320.0,360.0799999999872,BEANTE Beantech Srl,,,,,
9.01.017,RICAVI C/VENDITE ,31/10/2021,229,CESS.COMPENS.REV.CH,214221,26/10/2021,289,-479000.0,479360.08,LEICAM Leica Microsystems,,,,,
9.01.017,RICAVI C/VENDITE ,31/10/2021,150,Giroconto Cessione ,214221,26/10/2021, ,479000.0,360.0799999999581,LEICAM Leica Microsystems,,,,,
9.01.017,RICAVI C/VENDITE ,31/10/2021,229,CESS.COMPENS.REV.CH,01014/0,26/10/2021,290,-505.7,865.7799999999581,DELTEK DELTEK SRL,,,,,
9.01.017,RICAVI C/VENDITE ,31/10/2021,150,Giroconto Cessione ,01014/0,26/10/2021, ,505.7,360.0799999999581,DELTEK DELTEK SRL,,,,,
9.01.017,RICAVI C/VENDITE ,31/10/2021,229,CESS.COMPENS.REV.CH,941,29/10/2021,291,-10265.01,10625.08999999996,VIMAB VIMAB S.R.L.,,,,,
9.01.017,RICAVI C/VENDITE ,31/10/2021,150,Giroconto Cessione ,941,29/10/2021, ,10265.01,360.0799999999581,VIMAB VIMAB S.R.L.,,,,,
9.01.017,RICAVI C/VENDITE ,31/10/2021,229,CESS.COMPENS.REV.CH,58/PRSP,28/10/2021,292,-1453.0,1813.079999999958,SIALSR S.I.A.L. SRL,,,,,
9.01.017,RICAVI C/VENDITE ,31/10/2021,150,Giroconto Cessione ,58/PRSP,28/10/2021, ,1453.0,360.0799999999581,SIALSR S.I.A.L. SRL,,,,,
9.01.017,RICAVI C/VENDITE ,31/10/2021,229,CESS.COMPENS.REV.CH,65163,26/10/2021,293,-20444.73,20804.80999999996,ENELDI ENEL DISTRIBUZIONE,,,,,
9.01.017,RICAVI C/VENDITE ,31/10/2021,150,Giroconto Cessione ,65163,26/10/2021, ,20444.73,360.0799999999581,ENELDI ENEL DISTRIBUZIONE,,,,,
9.01.017,RICAVI C/VENDITE ,31/10/2021,229,CESS.COMPENS.REV.CH,247,25/10/2021,287,-300.0,660.0799999999581,NUOQUA NUOVA QUADRIFOGLIO,,,,,
9.01.017,RICAVI C/VENDITE ,31/10/2021,150,Giroconto Cessione ,100753,06/10/2021, ,360.08,299.9999999999581,FISHER FISHER SCIENTIFIC,,,,,
9.01.017,RICAVI C/VENDITE ,30/11/2021,229,CESS.COMPENS.REV.CH,92413,31/10/2021,297,-320.1,620.0999999999581,VWR VWR INTERNATIONAL,,,,,
9.01.017,RICAVI C/VENDITE ,30/11/2021,150,Giroconto Cessione ,92413,31/10/2021, ,320.1,299.999999999958,VWR VWR INTERNATIONAL,,,,,
9.01.017,RICAVI C/VENDITE ,30/11/2021,229,CESS.COMPENS.REV.CH,12-B ,23/10/2021,298,-150500.0,150800.0,ALGASS AL.G.ASS. S.R.L.,,,,,
9.01.017,RICAVI C/VENDITE ,30/11/2021,150,Giroconto Cessione ,12-B ,23/10/2021, ,150500.0,299.9999999999709,ALGASS AL.G.ASS. S.R.L.,,,,,
9.01.017,RICAVI C/VENDITE ,30/11/2021,229,CESS.COMPENS.REV.CH,121,02/11/2021,299,-600.4,900.3999999999709,HOSMOT HOSMOTIC SRL,,,,,
9.01.017,RICAVI C/VENDITE ,30/11/2021,229,CESS.COMPENS.REV.CH,702,02/11/2021,300,-23.81,924.2099999999708,ALGEN ALGEN S.R.L.,,,,,
9.01.017,RICAVI C/VENDITE ,30/11/2021,150,Giroconto Cessione ,702,02/11/2021, ,23.81,900.3999999999709,ALGEN ALGEN S.R.L.,,,,,
9.01.017,RICAVI C/VENDITE ,30/11/2021,217,CESS. COMPENS. ART.,1415,30/10/2021,301,-7.16,907.5599999999708,EDIBEN EDIL BEN S.R.L.,,,,,
9.01.017,RICAVI C/VENDITE ,30/11/2021,150,Giroconto Cessione ,1415,30/10/2021, ,7.16,900.3999999999709,EDIBEN EDIL BEN S.R.L.,,,,,
9.01.017,RICAVI C/VENDITE ,30/11/2021,229,CESS.COMPENS.REV.CH,11,29/10/2021,302,-424500.0,425400.4,BIODMO BIO3DMODEL SRL,,,,,
9.01.017,RICAVI C/VENDITE ,30/11/2021,150,Giroconto Cessione ,11,29/10/2021, ,424500.0,900.3999999999651,BIODMO BIO3DMODEL SRL,,,,,
9.01.017,RICAVI C/VENDITE ,30/11/2021,229,CESS.COMPENS.REV.CH,124,03/11/2021,303,-400.0,1300.399999999965,HOSMOT HOSMOTIC SRL,,,,,
9.01.017,RICAVI C/VENDITE ,30/11/2021,150,Giroconto Cessione ,124,03/11/2021, ,400.0,900.3999999999651,HOSMOT HOSMOTIC SRL,,,,,
9.01.017,RICAVI C/VENDITE ,30/11/2021,1229,CESS.COMPENS.REV.CH,3,02/11/2021,304,600.4,299.9999999999651,HOSMOT HOSMOTIC SRL,,,,,
9.01.017,RICAVI C/VENDITE ,30/11/2021,160,Giroconto Cessione ,3,02/11/2021, ,-600.4,900.3999999999651,HOSMOT HOSMOTIC SRL,,,,,
9.01.017,RICAVI C/VENDITE ,30/11/2021,229,CESS.COMPENS.REV.CH,5290,29/10/2021,305,-488.0,1388.399999999965,SPACEI Bio-Techne s.r.l.,,,,,
9.01.017,RICAVI C/VENDITE ,30/11/2021,150,Giroconto Cessione ,5290,29/10/2021, ,488.0,900.3999999999651,SPACEI Bio-Techne s.r.l.,,,,,
9.01.017,RICAVI C/VENDITE ,30/11/2021,229,CESS.COMPENS.REV.CH,66737,31/10/2021,306,-123.46,1023.859999999965,SIAD S.I.A.D. S.P.A.,,,,,
9.01.017,RICAVI C/VENDITE ,30/11/2021,150,Giroconto Cessione ,66737,31/10/2021, ,123.46,900.3999999999651,SIAD S.I.A.D. S.P.A.,,,,,
9.01.017,RICAVI C/VENDITE ,30/11/2021,229,CESS.COMPENS.REV.CH,13908,29/10/2021,307,-1748.0,2648.399999999965,RSTORE R-Store S.p.A.,,,,,
9.01.017,RICAVI C/VENDITE ,30/11/2021,150,Giroconto Cessione ,13908,29/10/2021, ,1748.0,900.3999999999651,RSTORE R-Store S.p.A.,,,,,
9.01.017,RICAVI C/VENDITE ,30/11/2021,229,CESS.COMPENS.REV.CH,1452,04/11/2021,308,-262310.0,263210.4,REMAKS REMAK SRL,,,,,
9.01.017,RICAVI C/VENDITE ,30/11/2021,150,Giroconto Cessione ,1452,04/11/2021, ,262310.0,900.3999999999651,REMAKS REMAK SRL,,,,,
9.01.017,RICAVI C/VENDITE ,30/11/2021,229,CESS.COMPENS.REV.CH,FPR35 ,28/10/2021,309,-10000.0,10900.39999999997,SOCIE5 SOCIETA' GENERALE,,,,,
9.01.017,RICAVI C/VENDITE ,30/11/2021,150,Giroconto Cessione ,FPR35 ,28/10/2021, ,10000.0,900.3999999999651,SOCIE5 SOCIETA' GENERALE,,,,,
9.01.017,RICAVI C/VENDITE ,30/11/2021,229,CESS.COMPENS.REV.CH,FPR276 ,08/11/2021,310,-339.0,1239.399999999965,NUOQUA NUOVA QUADRIFOGLIO,,,,,
9.01.017,RICAVI C/VENDITE ,30/11/2021,150,Giroconto Cessione ,FPR276 ,08/11/2021, ,339.0,900.3999999999651,NUOQUA NUOVA QUADRIFOGLIO,,,,,
9.01.017,RICAVI C/VENDITE ,30/11/2021,229,CESS.COMPENS.REV.CH,423/04 ,05/11/2021,311,-772.0,1672.399999999965,ROBOZE ROBOZE SPA,,,,,
9.01.017,RICAVI C/VENDITE ,30/11/2021,150,Giroconto Cessione ,423/04 ,05/11/2021, ,772.0,900.3999999999651,ROBOZE ROBOZE SPA,,,,,
9.01.017,RICAVI C/VENDITE ,30/11/2021,150,Giroconto Cessione ,FPR24 ,09/11/2021, ,137000.0,-136099.6,KRATOS KRATOS S.R.L.,,,,,
9.01.017,RICAVI C/VENDITE ,30/11/2021,229,CESS.COMPENS.REV.CH,FPR24 ,09/11/2021,312,-137000.0,900.3999999999651,KRATOS KRATOS S.R.L.,,,,,
9.01.017,RICAVI C/VENDITE ,30/11/2021,229,CESS.COMPENS.REV.CH,112,09/11/2021,313,-1800.0,2700.399999999965,START START-UP IMPRESA S,,,,,
9.01.017,RICAVI C/VENDITE ,30/11/2021,150,Giroconto Cessione ,112,09/11/2021, ,1800.0,900.3999999999651,START START-UP IMPRESA S,,,,,
9.01.017,RICAVI C/VENDITE ,30/11/2021,229,CESS.COMPENS.REV.CH,66/PRSP,09/11/2021,314,-252.0,1152.399999999965,SIALSR S.I.A.L. SRL,,,,,
9.01.017,RICAVI C/VENDITE ,30/11/2021,150,Giroconto Cessione ,66/PRSP,09/11/2021, ,252.0,900.3999999999651,SIALSR S.I.A.L. SRL,,,,,
9.01.017,RICAVI C/VENDITE ,30/11/2021,229,CESS.COMPENS.REV.CH,680/21 ,10/11/2021,315,-15471.86,16372.25999999997,NOINTE NOVA INFORMATION T,,,,,
9.01.017,RICAVI C/VENDITE ,30/11/2021,150,Giroconto Cessione ,680/21 ,10/11/2021, ,15471.86,900.3999999999651,NOINTE NOVA INFORMATION T,,,,,
9.01.017,RICAVI C/VENDITE ,30/11/2021,2229,CESS.COMPENS.REV.CH,37003,10/11/2021,316,-1333.1,2233.499999999965,SIGMAA SIGMA ALDRICH S.R.,,,,,
9.01.017,RICAVI C/VENDITE ,30/11/2021,150,Giroconto Cessione ,37003,10/11/2021, ,1333.1,900.3999999999651,SIGMAA SIGMA ALDRICH S.R.,,,,,
9.01.017,RICAVI C/VENDITE ,30/11/2021,229,CESS.COMPENS.REV.CH,37955,11/11/2021,317,-368.0,1268.399999999965,SIGMAA SIGMA ALDRICH S.R.,,,,,
9.01.017,RICAVI C/VENDITE ,30/11/2021,150,Giroconto Cessione ,37955,11/11/2021, ,368.0,900.3999999999651,SIGMAA SIGMA ALDRICH S.R.,,,,,
9.01.017,RICAVI C/VENDITE ,30/11/2021,229,CESS.COMPENS.REV.CH,93,10/11/2021,318,-12997.54,13897.93999999997,DAMBGI DITTA D'AMBRA GIUS,,,,,
9.01.017,RICAVI C/VENDITE ,30/11/2021,150,Giroconto Cessione ,93,10/11/2021, ,12997.54,900.3999999999651,DAMBGI DITTA D'AMBRA GIUS,,,,,
9.01.017,RICAVI C/VENDITE ,30/11/2021,229,CESS.COMPENS.REV.CH,38698,12/11/2021,319,-208.8,1109.199999999965,SIGMAA SIGMA ALDRICH S.R.,,,,,
9.01.017,RICAVI C/VENDITE ,30/11/2021,150,Giroconto Cessione ,38698,12/11/2021, ,208.8,900.3999999999651,SIGMAA SIGMA ALDRICH S.R.,,,,,
9.01.017,RICAVI C/VENDITE ,30/11/2021,229,CESS.COMPENS.REV.CH,380,30/10/2021,320,-34.07,934.4699999999651,SMARTP SMART PIU' S.R.L.,,,,,
9.01.017,RICAVI C/VENDITE ,30/11/2021,150,Giroconto Cessione ,380,30/10/2021, ,34.07,900.3999999999651,SMARTP SMART PIU' S.R.L.,,,,,
9.01.017,RICAVI C/VENDITE ,30/11/2021,229,CESS.COMPENS.REV.CH,65670,03/11/2021,321,-13.02,913.4199999999651,BANEMI BPER BANCA S.P.A.,,,,,
9.01.017,RICAVI C/VENDITE ,30/11/2021,150,Giroconto Cessione ,65670,03/11/2021, ,13.02,900.3999999999651,BANEMI BPER BANCA S.P.A.,,,,,
9.01.017,RICAVI C/VENDITE ,30/11/2021,229,CESS.COMPENS.REV.CH,39390,13/11/2021,322,-159.1,1059.499999999965,SIGMAA SIGMA ALDRICH S.R.,,,,,
9.01.017,RICAVI C/VENDITE ,30/11/2021,150,Giroconto Cessione ,39390,13/11/2021, ,159.1,900.399999999965,SIGMAA SIGMA ALDRICH S.R.,,,,,
9.01.017,RICAVI C/VENDITE ,30/11/2021,229,CESS.COMPENS.REV.CH,FPR36 ,11/11/2021,323,-8000.0,8900.399999999965,SOCIE5 SOCIETA' GENERALE,,,,,
9.01.017,RICAVI C/VENDITE ,30/11/2021,150,Giroconto Cessione ,FPR36 ,11/11/2021, ,8000.0,900.3999999999651,SOCIE5 SOCIETA' GENERALE,,,,,
9.01.017,RICAVI C/VENDITE ,30/11/2021,1229,CESS.COMPENS.REV.CH,3292,17/11/2021,324,685.0,215.3999999999651,NOTGER NOTARBARTOLO & GER,,,,,
9.01.017,RICAVI C/VENDITE ,30/11/2021,160,Giroconto Cessione ,3292,17/11/2021, ,-685.0,900.3999999999651,NOTGER NOTARBARTOLO & GER,,,,,
9.01.017,RICAVI C/VENDITE ,30/11/2021,1229,CESS.COMPENS.REV.CH,3293,17/11/2021,325,1315.0,-414.6000000000349,NOTGER NOTARBARTOLO & GER,,,,,
9.01.017,RICAVI C/VENDITE ,30/11/2021,160,Giroconto Cessione ,3293,17/11/2021, ,-1315.0,900.3999999999651,NOTGER NOTARBARTOLO & GER,,,,,
9.01.017,RICAVI C/VENDITE ,30/11/2021,1229,CESS.COMPENS.REV.CH,3294,17/11/2021,326,950.0,-49.60000000003492,NOTGER NOTARBARTOLO & GER,,,,,
9.01.017,RICAVI C/VENDITE ,30/11/2021,160,Giroconto Cessione ,3294,17/11/2021, ,-950.0,900.3999999999651,NOTGER NOTARBARTOLO & GER,,,,,
9.01.017,RICAVI C/VENDITE ,30/11/2021,1229,CESS.COMPENS.REV.CH,3295,17/11/2021,327,950.0,-49.60000000003492,NOTGER NOTARBARTOLO & GER,,,,,
9.01.017,RICAVI C/VENDITE ,30/11/2021,160,Giroconto Cessione ,3295,17/11/2021, ,-950.0,900.3999999999651,NOTGER NOTARBARTOLO & GER,,,,,
9.01.017,RICAVI C/VENDITE ,30/11/2021,229,CESS.COMPENS.REV.CH,3297,17/11/2021,328,-4250.0,5150.399999999965,NOTGER NOTARBARTOLO & GER,,,,,
9.01.017,RICAVI C/VENDITE ,30/11/2021,150,Giroconto Cessione ,3297,17/11/2021, ,4250.0,900.3999999999651,NOTGER NOTARBARTOLO & GER,,,,,
9.01.017,RICAVI C/VENDITE ,30/11/2021,229,CESS.COMPENS.REV.CH,49,30/11/2021,329,-21500.0,22400.39999999997,R4I R4I S.R.L.,,,,,
9.01.017,RICAVI C/VENDITE ,30/11/2021,150,GIROCONTO CESSIONE , ,30/11/2021, ,21500.0,900.3999999999651,R4I R4I S.R.L.,,,,,
9.01.017,RICAVI C/VENDITE ,30/11/2021,229,CESS.COMPENS.REV.CH,206813,19/11/2021,330,-3829.05,4729.449999999965,PERKIN PerkinElmer Italia,,,,,
9.01.017,RICAVI C/VENDITE ,30/11/2021,150,Giroconto Cessione ,206813,19/11/2021, ,3829.05,900.3999999999651,PERKIN PerkinElmer Italia,,,,,
9.01.017,RICAVI C/VENDITE ,30/11/2021,229,CESS.COMPENS.REV.CH,84883,22/11/2021,331,-363.0,1263.399999999965,DANEA DANEA SOFT SRL,,,,,
9.01.017,RICAVI C/VENDITE ,30/11/2021,150,Giroconto Cessione ,84883,22/11/2021, ,363.0,900.3999999999651,DANEA DANEA SOFT SRL,,,,,
9.01.017,RICAVI C/VENDITE ,30/11/2021,229,CESS.COMPENS.REV.CH,60385,20/11/2021,332,-519.8,1420.199999999965,VODAFO VODAFONE ITALIA S.,,,,,
9.01.017,RICAVI C/VENDITE ,30/11/2021,150,Giroconto Cessione ,60385,20/11/2021, ,519.8,900.3999999999651,VODAFO VODAFONE ITALIA S.,,,,,
9.01.017,RICAVI C/VENDITE ,30/11/2021,229,CESS.COMPENS.REV.CH,19,25/11/2021,333,-2625.0,3525.399999999965,DATTIL DATTILO S.C. A R.L,,,,,
9.01.017,RICAVI C/VENDITE ,30/11/2021,150,Giroconto Cessione ,19,25/11/2021, ,2625.0,900.3999999999651,DATTIL DATTILO S.C. A R.L,,,,,
9.01.017,RICAVI C/VENDITE ,30/11/2021,229,CESS.COMPENS.REV.CH,3693/V1,25/11/2021,334,-245.82,1146.219999999965,ELECAM ELETTROCAMPANIA S.,,,,,
9.01.017,RICAVI C/VENDITE ,30/11/2021,150,Giroconto Cessione ,3693/V1,25/11/2021, ,245.82,900.3999999999651,ELECAM ELETTROCAMPANIA S.,,,,,
9.01.017,RICAVI C/VENDITE ,30/11/2021,229,CESS.COMPENS.REV.CH,A10730 ,30/11/2021,336,-4223.0,5123.399999999965,PRODO1 PRODOTTI GIANNI SR,,,,,
9.01.017,RICAVI C/VENDITE ,30/11/2021,150,Giroconto Cessione ,A10730 ,30/11/2021, ,4223.0,900.3999999999651,PRODO1 PRODOTTI GIANNI SR,,,,,
9.01.017,RICAVI C/VENDITE ,30/11/2021,217,CESS. COMPENS. ART.,63765,10/11/2021,340,-24.4,924.799999999965,YUHAIT YUHAITENG KEJI YOU,,,,,
9.01.017,RICAVI C/VENDITE ,30/11/2021,150,Giroconto Cessione ,63765,10/11/2021, ,24.4,900.3999999999651,YUHAIT YUHAITENG KEJI YOU,,,,,
9.01.017,RICAVI C/VENDITE ,30/11/2021,217,CESS. COMPENS. ART.,4855,10/10/2021,342,-27.86,928.2599999999651,LONGHU LONGHUA XINQU DALA,,,,,
9.01.017,RICAVI C/VENDITE ,30/11/2021,150,Giroconto Cessione ,4855,10/10/2021, ,27.86,900.3999999999651,LONGHU LONGHUA XINQU DALA,,,,,
9.01.017,RICAVI C/VENDITE ,30/11/2021,217,CESS. COMPENS. ART.,4852,10/10/2021,341,-30.32,930.7199999999651,LONGHU LONGHUA XINQU DALA,,,,,
9.01.017,RICAVI C/VENDITE ,30/11/2021,150,Giroconto Cessione ,4852,10/10/2021, ,30.32,900.3999999999651,LONGHU LONGHUA XINQU DALA,,,,,
9.01.017,RICAVI C/VENDITE ,30/11/2021,217,CESS. COMPENS. ART.,32477,08/10/2021,343,-286.18,1186.579999999965,JUNHON SHENZEN SHI JUNHON,,,,,
9.01.017,RICAVI C/VENDITE ,30/11/2021,150,Giroconto Cessione ,32477,08/10/2021, ,286.18,900.3999999999651,JUNHON SHENZEN SHI JUNHON,,,,,
9.01.017,RICAVI C/VENDITE ,30/11/2021,217,CESS. COMPENS. ART.,7155,09/10/2021,344,-32.72,933.1199999999651,GUAHOU GUANGZHOUJIUJINGMA,,,,,
9.01.017,RICAVI C/VENDITE ,30/11/2021,150,Giroconto Cessione ,7155,09/10/2021, ,32.72,900.3999999999651,GUAHOU GUANGZHOUJIUJINGMA,,,,,
9.01.017,RICAVI C/VENDITE ,30/11/2021,217,CESS. COMPENS. ART.,320,06/02/2020,345,-99.96,1000.359999999965,NOOELE NOOLEC INC.,,,,,
9.01.017,RICAVI C/VENDITE ,30/11/2021,150,Giroconto Cessione ,320,06/02/2020, ,99.96,900.3999999999651,NOOELE NOOLEC INC.,,,,,
9.01.017,RICAVI C/VENDITE ,30/11/2021,217,CESS. COMPENS. ART.,3767,10/06/2021,346,-754.07,1654.469999999965,FORJOU FORTUNE JOURNALS,,,,,
9.01.017,RICAVI C/VENDITE ,30/11/2021,150,Giroconto Cessione ,3767,10/06/2021, ,754.07,900.3999999999652,FORJOU FORTUNE JOURNALS,,,,,
9.01.017,RICAVI C/VENDITE ,30/11/2021,150,Giroconto Cessione ,121,02/11/2021, ,600.4,299.9999999999652,HOSMOT HOSMOTIC SRL,,,,,
9.01.017,RICAVI C/VENDITE ,20/12/2021,229,CESS.COMPENS.REV.CH,3468 A ,30/11/2021,347,-4650.0,4949.999999999965,DBA D.B.A. ITALIA S.R.,,,,,
9.01.017,RICAVI C/VENDITE ,20/12/2021,150,Giroconto Cessione ,3468 A ,30/11/2021, ,4650.0,299.9999999999654,DBA D.B.A. ITALIA S.R.,,,,,
9.01.017,RICAVI C/VENDITE ,20/12/2021,229,CESS.COMPENS.REV.CH,738,30/11/2021,348,-6.97,306.9699999999655,ALGEN ALGEN S.R.L.,,,,,
9.01.017,RICAVI C/VENDITE ,20/12/2021,150,Giroconto Cessione ,738,30/11/2021, ,6.97,299.9999999999654,ALGEN ALGEN S.R.L.,,,,,
9.01.017,RICAVI C/VENDITE ,20/12/2021,229,CESS.COMPENS.REV.CH,84994,30/11/2021,349,-326.75,626.7499999999654,SIAD S.I.A.D. S.P.A.,,,,,
9.01.017,RICAVI C/VENDITE ,20/12/2021,150,Giroconto Cessione ,84994,30/11/2021, ,326.75,299.9999999999654,SIAD S.I.A.D. S.P.A.,,,,,
9.01.017,RICAVI C/VENDITE ,20/12/2021,229,CESS.COMPENS.REV.CH,67086,29/11/2021,350,-49.8,349.7999999999655,LINKEM LINKEM S.P.A.,,,,,
9.01.017,RICAVI C/VENDITE ,20/12/2021,150,Giroconto Cessione ,67086,29/11/2021, ,49.8,299.9999999999654,LINKEM LINKEM S.P.A.,,,,,
9.01.017,RICAVI C/VENDITE ,20/12/2021,229,CESS.COMPENS.REV.CH,FPR28 ,09/12/2021,351,-25000.0,25299.99999999996,KRATOS KRATOS S.R.L.,,,,,
9.01.017,RICAVI C/VENDITE ,20/12/2021,150,Giroconto Cessione ,FPR28 ,09/12/2021, ,25000.0,299.9999999999636,KRATOS KRATOS S.R.L.,,,,,
9.01.017,RICAVI C/VENDITE ,20/12/2021,229,CESS.COMPENS.REV.CH,FPR26 ,09/12/2021,352,-30000.0,30299.99999999996,KRATOS KRATOS S.R.L.,,,,,
9.01.017,RICAVI C/VENDITE ,20/12/2021,150,Giroconto Cessione ,FPR26 ,09/12/2021, ,30000.0,299.9999999999636,KRATOS KRATOS S.R.L.,,,,,
9.01.017,RICAVI C/VENDITE ,20/12/2021,1229,CESS.COMPENS.REV.CH,FPR27 ,09/12/2021,353,30000.0,-29700.00000000004,KRATOS KRATOS S.R.L.,,,,,
9.01.017,RICAVI C/VENDITE ,20/12/2021,160,Giroconto Cessione ,FPR27 ,09/12/2021, ,-30000.0,299.9999999999636,KRATOS KRATOS S.R.L.,,,,,
9.01.017,RICAVI C/VENDITE ,20/12/2021,229,CESS.COMPENS.REV.CH,45772,09/12/2021,354,-133.3,433.2999999999636,ELECAM ELETTROCAMPANIA S.,,,,,
9.01.017,RICAVI C/VENDITE ,20/12/2021,150,Giroconto Cessione ,45772,09/12/2021, ,133.3,299.9999999999636,ELECAM ELETTROCAMPANIA S.,,,,,
9.01.017,RICAVI C/VENDITE ,20/12/2021,229,CESS.COMPENS.REV.CH,55134,13/12/2021,355,-2429.7,2729.699999999963,SIGMAA SIGMA ALDRICH S.R.,,,,,
9.01.017,RICAVI C/VENDITE ,20/12/2021,150,Giroconto Cessione ,55134,13/12/2021, ,2429.7,299.9999999999636,SIGMAA SIGMA ALDRICH S.R.,,,,,
9.01.017,RICAVI C/VENDITE ,20/12/2021,229,CESS.COMPENS.REV.CH,326,14/12/2021,356,-300.0,599.9999999999636,NUOQUA NUOVA QUADRIFOGLIO,,,,,
9.01.017,RICAVI C/VENDITE ,20/12/2021,150,Giroconto Cessione ,326,14/12/2021, ,300.0,299.9999999999636,NUOQUA NUOVA QUADRIFOGLIO,,,,,
9.01.017,RICAVI C/VENDITE ,20/12/2021,229,CESS.COMPENS.REV.CH,234,14/12/2021,357,-104.92,404.9199999999636,GBVEND GB VENDING SRLS,,,,,
9.01.017,RICAVI C/VENDITE ,20/12/2021,150,Giroconto Cessione ,234,14/12/2021, ,104.92,299.9999999999636,GBVEND GB VENDING SRLS,,,,,
9.01.017,RICAVI C/VENDITE ,20/12/2021,229,CESS.COMPENS.REV.CH,89677,02/12/2021,358,-13.02,313.0199999999636,BANEMI BPER BANCA S.P.A.,,,,,
9.01.017,RICAVI C/VENDITE ,20/12/2021,150,Giroconto Cessione ,89677,02/12/2021, ,13.02,299.9999999999636,BANEMI BPER BANCA S.P.A.,,,,,
9.01.017,RICAVI C/VENDITE ,20/12/2021,229,CESS.COMPENS.REV.CH,M50206 ,13/12/2021,359,-1834.57,2134.569999999963,EDENRE EDENRED ITALIA Srl,,,,,
9.01.017,RICAVI C/VENDITE ,20/12/2021,150,Giroconto Cessione ,M50206 ,13/12/2021, ,1834.57,299.9999999999634,EDENRE EDENRED ITALIA Srl,,,,,
9.01.017,RICAVI C/VENDITE ,20/12/2021,229,CESS.COMPENS.REV.CH,1166/03,14/12/2021,360,-1701.06,2001.059999999963,LGSOLU L & G SOLUTION SRL,,,,,
9.01.017,RICAVI C/VENDITE ,20/12/2021,150,Giroconto Cessione ,1166/03,14/12/2021, ,1701.06,299.9999999999634,LGSOLU L & G SOLUTION SRL,,,,,
9.01.017,RICAVI C/VENDITE ,31/12/2021,150,Giroconto Cessione ,247,25/10/2021, ,300.0,-3.660716174636036e-11,NUOQUA NUOVA QUADRIFOGLIO,,,,,
9.01.017,RICAVI C/VENDITE ,31/12/2021,229,CESS.COMPENS.REV.CH,FPR43 ,16/12/2021,361,-15000.0,14999.99999999996,SOCIE5 SOCIETA' GENERALE,,,,,
9.01.017,RICAVI C/VENDITE ,31/12/2021,150,Giroconto Cessione ,FPR43 ,16/12/2021, ,15000.0,-3.637978807091713e-11,SOCIE5 SOCIETA' GENERALE,,,,,
9.01.017,RICAVI C/VENDITE ,31/12/2021,229,CESS.COMPENS.REV.CH,650,15/12/2021,362,-226.0,225.9999999999636,TECECO TECNO-ECO S.R.L.,,,,,
9.01.017,RICAVI C/VENDITE ,31/12/2021,150,Giroconto Cessione ,650,15/12/2021, ,226.0,-3.637978807091713e-11,TECECO TECNO-ECO S.R.L.,,,,,
9.01.017,RICAVI C/VENDITE ,31/12/2021,1229,CESS.COMPENS.REV.CH,6,15/12/2021,363,226.0,-226.0000000000364,TECECO TECNO-ECO S.R.L.,,,,,
9.01.017,RICAVI C/VENDITE ,31/12/2021,160,Giroconto Cessione ,6,15/12/2021, ,-226.0,-3.637978807091713e-11,TECECO TECNO-ECO S.R.L.,,,,,
9.01.017,RICAVI C/VENDITE ,31/12/2021,1229,CESS.COMPENS.REV.CH,359570,22/12/2021,364,2429.7,-2429.700000000036,SIGMAA SIGMA ALDRICH S.R.,,,,,
9.01.017,RICAVI C/VENDITE ,31/12/2021,160,Giroconto Cessione ,359570,22/12/2021, ,-2429.7,-3.637978807091713e-11,SIGMAA SIGMA ALDRICH S.R.,,,,,
9.01.017,RICAVI C/VENDITE ,31/12/2021,2229,CESS.COMPENS.REV.CH,359571,22/12/2021,365,-2429.7,2429.699999999963,SIGMAA SIGMA ALDRICH S.R.,,,,,
9.01.017,RICAVI C/VENDITE ,31/12/2021,150,Giroconto Cessione ,359571,22/12/2021, ,2429.7,-3.637978807091713e-11,SIGMAA SIGMA ALDRICH S.R.,,,,,
9.01.017,RICAVI C/VENDITE ,31/12/2021,150,Giroconto Cessione ,FPR18 ,23/12/2021, ,344.26,-344.2600000000364,MATTSR MATTIA S.R.L.,,,,,
9.01.017,RICAVI C/VENDITE ,31/12/2021,229,CESS.COMPENS.REV.CH,FPR18 ,23/12/2021,366,-344.26,-3.637978807091713e-11,MATTSR MATTIA S.R.L.,,,,,
9.01.017,RICAVI C/VENDITE ,31/12/2021,229,CESS.COMPENS.REV.CH,1701,22/12/2021,367,-4990.0,4989.999999999964,REMAKS REMAK SRL,,,,,
9.01.017,RICAVI C/VENDITE ,31/12/2021,150,Giroconto Cessione ,1701,22/12/2021, ,4990.0,-3.637978807091713e-11,REMAKS REMAK SRL,,,,,
9.01.017,RICAVI C/VENDITE ,31/12/2021,229,CESS.COMPENS.REV.CH,3667,23/12/2021,368,-200.0,199.9999999999636,NOTGER NOTARBARTOLO & GER,,,,,
9.01.017,RICAVI C/VENDITE ,31/12/2021,150,Giroconto Cessione ,3667,23/12/2021, ,200.0,-3.637978807091713e-11,NOTGER NOTARBARTOLO & GER,,,,,
9.01.017,RICAVI C/VENDITE ,31/12/2021,229,CESS.COMPENS.REV.CH,3668,23/12/2021,369,-420.0,419.9999999999636,NOTGER NOTARBARTOLO & GER,,,,,
9.01.017,RICAVI C/VENDITE ,31/12/2021,150,Giroconto Cessione ,3668,23/12/2021, ,420.0,-3.637978807091713e-11,NOTGER NOTARBARTOLO & GER,,,,,
9.01.017,RICAVI C/VENDITE ,31/12/2021,229,CESS.COMPENS.REV.CH,FPR334 ,27/12/2021,370,-300.0,299.9999999999636,NUOQUA NUOVA QUADRIFOGLIO,,,,,
9.01.017,RICAVI C/VENDITE ,31/12/2021,150,Giroconto Cessione ,FPR334 ,27/12/2021, ,300.0,-3.637978807091713e-11,NUOQUA NUOVA QUADRIFOGLIO,,,,,
9.01.017,RICAVI C/VENDITE ,31/12/2021,229,CESS.COMPENS.REV.CH,98/2021,30/12/2021,371,-4000.0,3999.999999999964,WORLDT WORLD TRAVEL BOUTI,,,,,
9.01.017,RICAVI C/VENDITE ,31/12/2021,150,Giroconto Cessione ,98/2021,30/12/2021, ,4000.0,-3.637978807091713e-11,WORLDT WORLD TRAVEL BOUTI,,,,,
9.01.017,RICAVI C/VENDITE ,31/12/2021,229,CESS.COMPENS.REV.CH,831,30/12/2021,372,-6.97,6.96999999996362,ALGEN ALGEN S.R.L.,,,,,
9.01.017,RICAVI C/VENDITE ,31/12/2021,150,Giroconto Cessione ,831,30/12/2021, ,6.97,-3.637978807091713e-11,ALGEN ALGEN S.R.L.,,,,,
9.01.017,RICAVI C/VENDITE ,31/12/2021,229,CESS.COMPENS.REV.CH,787/21 ,30/12/2021,373,-3108.97,3108.969999999963,NOINTE NOVA INFORMATION T,,,,,
9.01.017,RICAVI C/VENDITE ,31/12/2021,150,Giroconto Cessione ,787/21 ,30/12/2021, ,3108.97,-3.637978807091713e-11,NOINTE NOVA INFORMATION T,,,,,
9.09.003,INTERESSI ATTIVI SU c/c BANCARI Periodo dal 01/01/21 al 31/12/21 ,31/12/2021,160,AVERE , ,31/12/2021, ,-4.72,4.72, diversi a diversi,,,,,
9.09.003,INTERESSI ATTIVI SU c/c BANCARI Periodo dal 01/01/21 al 31/12/21 ,31/12/2021,160,AVERE , ,31/12/2021, ,-8.44,13.16, diversi a diversi,,,,,
9.11.003,ARROTONDAMENTI ATTIVI ,18/01/2021,160,ADDEB.RITEN.DICEMBR, ,18/01/2021, ,-1.27,1.27, diversi a diversi,,,,,
9.11.003,ARROTONDAMENTI ATTIVI ,31/01/2021,160,RETRIBUZ.OMEGA GENN, ,31/01/2021, ,-0.62,1.89, diversi a diversi,,,,,
9.11.003,ARROTONDAMENTI ATTIVI ,31/01/2021,160,"RETRIBUZ,THETA GENN", ,31/01/2021, ,-0.18,2.07, diversi a diversi,,,,,
9.11.003,ARROTONDAMENTI ATTIVI ,31/01/2021,160,RETRIBUZ.BETA GENNA, ,31/01/2021, ,-1.58,3.65, diversi a diversi,,,,,
9.11.003,ARROTONDAMENTI ATTIVI ,28/02/2021,160,"RETRIBUZ,THETA FEBB", ,28/02/2021, ,-2.44,6.09, diversi a diversi,,,,,
9.11.003,ARROTONDAMENTI ATTIVI ,16/03/2021,160,AVERE , ,16/03/2021, ,-0.03,6.12,SIDSPA SIDERSAN SPA,,,,,
9.11.003,ARROTONDAMENTI ATTIVI ,31/03/2021,160,RETRIBUZ.THETA MARZ, ,31/03/2021, ,-1.63,7.75, diversi a diversi,,,,,
9.11.003,ARROTONDAMENTI ATTIVI ,31/03/2021,160,RETRIBUZ.IOTA MARZO, ,31/03/2021, ,-0.33,8.08, diversi a diversi,,,,,
9.11.003,ARROTONDAMENTI ATTIVI ,31/03/2021,160,RETRIBUZ.BETA MARZO, ,31/03/2021, ,-2.4,10.48, diversi a diversi,,,,,
9.11.003,ARROTONDAMENTI ATTIVI ,16/04/2021,160,ADDEB.RITEN.MARZO , ,16/04/2021, ,-1.09,11.57, diversi a diversi,,,,,
9.11.003,ARROTONDAMENTI ATTIVI ,30/04/2021,160,"RETRIBUZ,OMEGA APRI", ,30/04/2021, ,-0.02,11.59, diversi a diversi,,,,,
9.11.003,ARROTONDAMENTI ATTIVI ,30/04/2021,160,RETRIBUZ.KAPPA AGOS, ,30/04/2021, ,-0.19,11.78, diversi a diversi,,,,,
9.11.003,ARROTONDAMENTI ATTIVI ,16/05/2021,160,"ADDEB,RITEN.APRILE ", ,16/05/2021, ,-0.39,12.17, diversi a diversi,,,,,
9.11.003,ARROTONDAMENTI ATTIVI ,31/05/2021,160,RETRIBUZ.ALFA MAGGI, ,31/05/2021, ,-0.95,13.12, diversi a diversi,,,,,
9.11.003,ARROTONDAMENTI ATTIVI ,31/05/2021,160,RETRIBUZ.OMEGA MAGG, ,31/05/2021, ,-0.37,13.49, diversi a diversi,,,,,
9.11.003,ARROTONDAMENTI ATTIVI ,31/05/2021,160,"RETRIBUZ,LAMBDA MAG", ,31/05/2021, ,-0.24,13.73, diversi a diversi,,,,,
9.11.003,ARROTONDAMENTI ATTIVI ,31/05/2021,160,RETRIBUZ.THETA MAGG, ,31/05/2021, ,-2.16,15.89, diversi a diversi,,,,,
9.11.003,ARROTONDAMENTI ATTIVI ,31/05/2021,160,RETRIBUZ.BETA MAGGI, ,31/05/2020, ,-0.51,16.4, diversi a diversi,,,,,
9.11.003,ARROTONDAMENTI ATTIVI ,16/06/2021,160,ADDEB.RITEN.MAGGIO , ,16/06/2021, ,-0.28,16.68, diversi a diversi,,,,,
9.11.003,ARROTONDAMENTI ATTIVI ,30/06/2021,160,RETRIBU.BETA GIUGNO, ,30/06/2021, ,-0.6,17.28, diversi a diversi,,,,,
9.11.003,ARROTONDAMENTI ATTIVI ,30/06/2021,160,"RETRIBUZ,IOTA GIUGN", ,30/06/2021, ,-1.03,18.31, diversi a diversi,,,,,
9.11.003,ARROTONDAMENTI ATTIVI ,30/06/2021,160,RETRIBUZIONI THETA , ,30/06/2021, ,-0.04,18.35, diversi a diversi,,,,,
9.11.003,ARROTONDAMENTI ATTIVI ,31/07/2021,160,"RETRIBUZ,LAMBDA LUG", ,31/07/2021, ,-1.83,20.18, diversi a diversi,,,,,
9.11.003,ARROTONDAMENTI ATTIVI ,31/07/2021,160,RETRIBUZ.TAU LUGLIO, ,31/07/2021, ,-0.84,21.02, diversi a diversi,,,,,
9.11.003,ARROTONDAMENTI ATTIVI ,31/07/2021,160,RETRIBUZ.RHO LUGLIO, ,31/07/2021, ,-0.17,21.19, diversi a diversi,,,,,
9.11.003,ARROTONDAMENTI ATTIVI ,31/07/2021,160,"RETRIBUZ,ZETA LUGLI", ,31/07/2021, ,-0.53,21.72, diversi a diversi,,,,,
9.11.003,ARROTONDAMENTI ATTIVI ,31/07/2021,160,RETRIBUZ.THETA LUGL, ,31/07/2021, ,-0.6,22.32, diversi a diversi,,,,,
9.11.003,ARROTONDAMENTI ATTIVI ,31/08/2021,160,RETRIBUZ.IOTA AGOST, ,31/08/2021, ,-0.22,22.54, diversi a diversi,,,,,
9.11.003,ARROTONDAMENTI ATTIVI ,31/08/2021,160,RETRIBUZ.ETA AGOSTO, ,31/08/2021, ,-0.55,23.09, diversi a diversi,,,,,
9.11.003,ARROTONDAMENTI ATTIVI ,31/08/2021,160,RETRIBUZ.RHO AGOSTO, ,31/08/2021, ,-0.17,23.26000000000001, diversi a diversi,,,,,
9.11.003,ARROTONDAMENTI ATTIVI ,15/09/2021,160,I RATA ACC.IMPOSTE , ,15/09/2021, ,-0.5,23.76000000000001, diversi a diversi,,,,,
9.11.003,ARROTONDAMENTI ATTIVI ,16/09/2021,160,ADDEB.RITEN.AGOSTO , ,16/09/2021, ,-1.29,25.05, diversi a diversi,,,,,
9.11.003,ARROTONDAMENTI ATTIVI ,30/09/2021,160,RETRIBUZ.OMEGA SETT, ,30/09/2021, ,-0.22,25.27, diversi a diversi,,,,,
9.11.003,ARROTONDAMENTI ATTIVI ,30/09/2021,160,RETRIBUZ.ZETA SETTE, ,30/09/2021, ,-0.81,26.08, diversi a diversi,,,,,
9.11.003,ARROTONDAMENTI ATTIVI ,30/09/2021,160,RETRIBUZ.THETA SETT, ,30/09/2021, ,-0.87,26.95, diversi a diversi,,,,,
9.11.003,ARROTONDAMENTI ATTIVI ,30/09/2021,160,RETRIBUZ.LAMBDA SET, ,30/09/2021, ,-0.27,27.22, diversi a diversi,,,,,
9.11.003,ARROTONDAMENTI ATTIVI ,30/09/2021,160,RETRIBUZ.RHO SETTEM, ,30/09/2021, ,-0.17,27.39, diversi a diversi,,,,,
9.11.003,ARROTONDAMENTI ATTIVI ,30/09/2021,160,"RETRIBUZ,BETA SETTE", ,30/09/2021, ,-0.82,28.21, diversi a diversi,,,,,
9.11.003,ARROTONDAMENTI ATTIVI ,31/10/2021,160,RETRIBUZ.BETA OTTOB, ,31/10/2021, ,-0.2,28.41, diversi a diversi,,,,,
9.11.003,ARROTONDAMENTI ATTIVI ,31/10/2021,160,"RETRIB,IOTA OTTOBRE", ,31/10/2021, ,-0.79,29.2, diversi a diversi,,,,,
9.11.003,ARROTONDAMENTI ATTIVI ,31/10/2021,160,RETRIB.ETA OTTOBRE , ,31/10/2021, ,-0.23,29.43, diversi a diversi,,,,,
9.11.003,ARROTONDAMENTI ATTIVI ,31/10/2021,160,RETRIBUZ.RHO OTTOBR, ,31/10/2021, ,-0.17,29.6, diversi a diversi,,,,,
9.11.003,ARROTONDAMENTI ATTIVI ,16/11/2021,160,ADDEB.RITEN.OTTOBRE, ,16/11/2021, ,-0.58,30.18, diversi a diversi,,,,,
9.11.003,ARROTONDAMENTI ATTIVI ,30/11/2021,160,RETRIB.THETA NOVEMB, ,30/11/2021, ,-0.02,30.2, diversi a diversi,,,,,
9.11.003,ARROTONDAMENTI ATTIVI ,30/11/2021,160,RETRIB.ETA NOVEMBRE, ,30/11/2021, ,-0.68,30.88, diversi a diversi,,,,,
9.11.003,ARROTONDAMENTI ATTIVI ,30/11/2021,160,RETRIBUZ.RHO NOVEMB, ,30/11/2021, ,-0.17,31.05, diversi a diversi,,,,,
9.11.003,ARROTONDAMENTI ATTIVI ,16/12/2021,160,ADDEB.RITEN.NOVEMBR, ,16/12/2021, ,-0.06,31.11, diversi a diversi,,,,,
9.11.003,ARROTONDAMENTI ATTIVI ,31/12/2021,160,RETRIB.ALFA DICEMBR, ,31/12/2021, ,-1.01,32.12, diversi a diversi,,,,,
9.11.003,ARROTONDAMENTI ATTIVI ,31/12/2021,160,RETRIBUZ.BETA , ,31/12/2021, ,-0.87,32.99, diversi a diversi,,,,,
9.11.003,ARROTONDAMENTI ATTIVI ,31/12/2021,160,RETRIB.ZETA DICEMBR, ,31/12/2021, ,-0.33,33.32, diversi a diversi,,,,,
9.11.003,ARROTONDAMENTI ATTIVI ,31/12/2021,160,RETRIB.THETA DICEMB, ,31/12/2021, ,-0.85,34.17, diversi a diversi,,,,,
9.11.003,ARROTONDAMENTI ATTIVI ,31/12/2021,160,RETRIBUZ.KAPPA DICE, ,31/12/2021, ,-0.53,34.7, diversi a diversi,,,,,
9.11.003,ARROTONDAMENTI ATTIVI ,31/12/2021,160,RETRIBUZ.ETA DICEMB, ,31/12/2021, ,-0.23,34.93, diversi a diversi,,,,,
9.11.008,DIFFERENZE CAMBI ,11/01/2021,160,S/PRO-FORMA BONIFIC, ,11/01/2021, ,-404.75,404.75,CRYSTR CRYSTAN LTD,,,,,
9.11.008,DIFFERENZE CAMBI ,24/05/2021,160,BONIFICO S/FATT. , ,24/05/2021, ,-68.67,473.42, diversi a diversi,,,,,
9.11.016,RIMBORSO SPESE ANTICIPATE ,13/09/2021,160,RIMB.SPESE PROCEDUR, ,13/09/2021, ,-3842.5,3842.5,102024 BANCA DELLA CAMPAN,,,,,
9.11.016,RIMBORSO SPESE ANTICIPATE ,13/10/2021,160,RIMB.SPESE PUBBL.NA, ,13/10/2021, ,-3870.84,7713.34,102024 BANCA DELLA CAMPAN,,,,,
9.11.016,RIMBORSO SPESE ANTICIPATE ,09/12/2021,160,SPESE PUBBL.BANDI R, ,09/12/2021, ,-3842.5,11555.84,102024 BANCA DELLA CAMPAN,,,,,
9.11.016,RIMBORSO SPESE ANTICIPATE ,13/12/2021,160,RIMB.PROC.GARA PERK, ,13/12/2021, ,-3870.84,15426.68, diversi a diversi,,,,,
9.11.016,RIMBORSO SPESE ANTICIPATE ,13/12/2021,160,RIMB.PROC.GARA ZEIS, ,13/12/2021, ,-3842.5,19269.18, diversi a diversi,,,,,
9.11.016,RIMBORSO SPESE ANTICIPATE ,13/12/2021,160,RIMB.SPESE PROC.GAR, ,13/12/2021, ,-3870.84,23140.02,102024 BANCA DELLA CAMPAN,,,,,
9.12.002,CONTRIBUTI IN CONTO ESERCIZIO ,02/01/2021,160,GIROCONTO RISCONTI , ,02/01/2021, ,-5596939.88,5596939.88,516001 RISCONTI PASSIVI,,,,,
9.12.002,CONTRIBUTI IN CONTO ESERCIZIO ,26/01/2021,160,ACCRED.CONTRIB.HORI, ,26/01/2021, ,-21022.99,5617962.87, diversi a diversi,,,,,
9.12.002,CONTRIBUTI IN CONTO ESERCIZIO ,26/01/2021,160,ACCRED.CONTRIB.HORI, ,26/01/2021, ,-2774.79,5620737.66, diversi a diversi,,,,,
9.12.002,CONTRIBUTI IN CONTO ESERCIZIO ,20/05/2021,160,RIBALT.CONTR.PROG.O, ,20/05/2021, ,-26981.69,5647719.350000001,102024 BANCA DELLA CAMPAN,,,,,
9.12.002,CONTRIBUTI IN CONTO ESERCIZIO ,24/05/2021,160,RIBALTAM.CONTR.PROG, ,24/05/2021, ,-48171.5,5695890.850000001,102024 BANCA DELLA CAMPAN,,,,,
9.12.002,CONTRIBUTI IN CONTO ESERCIZIO ,14/06/2021,160,RICH.X ACCRED.QUOTA, ,14/06/2021, ,-91025.08,5786915.930000001,214046 CREDITO X CONTRIBU,,,,,
9.12.002,CONTRIBUTI IN CONTO ESERCIZIO ,22/06/2021,160,QUOTA PROG.STARS , ,22/06/2021, ,-28986.6,5815902.53,102024 BANCA DELLA CAMPAN,,,,,
9.12.002,CONTRIBUTI IN CONTO ESERCIZIO ,02/07/2021,160,RIBALTAM.QUOTA PROG, ,02/07/2021, ,-52425.96,5868328.49,102024 BANCA DELLA CAMPAN,,,,,
9.12.002,CONTRIBUTI IN CONTO ESERCIZIO ,05/07/2021,160,TRASF.III QUOTA II , ,05/07/2021, ,-20000.0,5888328.49,102024 BANCA DELLA CAMPAN,,,,,
9.12.002,CONTRIBUTI IN CONTO ESERCIZIO ,08/07/2021,150,"STORNO CONTR,PROG,V", ,08/07/2020, ,856.29,5887472.2,102024 BANCA DELLA CAMPAN,,,,,
9.12.002,CONTRIBUTI IN CONTO ESERCIZIO ,27/07/2021,160,PROG.RECIPE DA POLI, ,26/07/2021, ,-39550.0,5927022.2,102024 BANCA DELLA CAMPAN,,,,,
9.12.002,CONTRIBUTI IN CONTO ESERCIZIO ,01/09/2021,160,INTEGRAZ.QUOTA STAR, ,01/09/2021, ,-32807.51,5959829.71,102024 BANCA DELLA CAMPAN,,,,,
9.12.002,CONTRIBUTI IN CONTO ESERCIZIO ,15/10/2021,160,PROG.H2020 INCISIVE, ,15/10/2021, ,-40630.21,6000459.92,102024 BANCA DELLA CAMPAN,,,,,
9.12.002,CONTRIBUTI IN CONTO ESERCIZIO ,28/10/2021,160,PROG.SIMONE MANAG.H, ,28/10/2021, ,-48889.89,6049349.81,102024 BANCA DELLA CAMPAN,,,,,
9.12.002,CONTRIBUTI IN CONTO ESERCIZIO ,08/11/2021,160,CONTR.MAIA ACCRED.M, ,08/11/2021, ,-85288.26,6134638.069999999, diversi a diversi,,,,,
9.12.002,CONTRIBUTI IN CONTO ESERCIZIO ,08/11/2021,160,ACCRED.CONTR.MAIA , ,08/11/2021, ,-330797.15,6465435.22, diversi a diversi,,,,,
9.12.002,CONTRIBUTI IN CONTO ESERCIZIO ,22/12/2021,160,ACCRED.F-MOBILITY R, ,22/12/2021, ,-257235.17,6722670.39,102024 BANCA DELLA CAMPAN,,,,,
9.12.002,CONTRIBUTI IN CONTO ESERCIZIO ,22/12/2021,160,ACCR.C-MOBILITY REG, ,22/12/2021, ,-217480.65,6940151.04,102024 BANCA DELLA CAMPAN,,,,,
9.12.002,CONTRIBUTI IN CONTO ESERCIZIO ,22/12/2021,160,ACCR.C-MOBILITY REG, ,22/12/2021, ,-21748.06,6961899.1,102024 BANCA DELLA CAMPAN,,,,,
9.12.002,CONTRIBUTI IN CONTO ESERCIZIO ,22/12/2021,160,ACCR.P-MOBILITY REG, ,22/12/2021, ,-198772.64,7160671.739999999,102024 BANCA DELLA CAMPAN,,,,,
9.12.002,CONTRIBUTI IN CONTO ESERCIZIO ,22/12/2021,160,ACCR.P-MOBILITY REG, ,22/12/2021, ,-19877.26,7180548.999999999,102024 BANCA DELLA CAMPAN,,,,,
9.12.002,CONTRIBUTI IN CONTO ESERCIZIO ,22/12/2021,160,ACCR.F-MOBILITY REG, ,22/12/2021, ,-60021.54,7240570.539999999,102024 BANCA DELLA CAMPAN,,,,,
9.12.002,CONTRIBUTI IN CONTO ESERCIZIO ,22/12/2021,160,ACCR.C-MOBILITY REG, ,22/12/2021, ,-50745.49,7291316.029999999,102024 BANCA DELLA CAMPAN,,,,,
9.12.002,CONTRIBUTI IN CONTO ESERCIZIO ,22/12/2021,160,ACCR.P-MOBILITY REG, ,22/12/2021, ,-46380.28,7337696.31,102024 BANCA DELLA CAMPAN,,,,,
9.12.002,CONTRIBUTI IN CONTO ESERCIZIO ,22/12/2021,160,ACCR.F-MOBILITY REG, ,22/12/2021, ,-25723.52,7363419.829999999,102024 BANCA DELLA CAMPAN,,,,,
9.12.002,CONTRIBUTI IN CONTO ESERCIZIO ,31/12/2021,150,MAIA PARTNER , ,31/12/2021, ,385521.43,6977898.399999999,510003 DEBITI DIVERSI,,,,,
9.12.002,CONTRIBUTI IN CONTO ESERCIZIO ,31/12/2021,150,C-MOBILITY PARTNER , ,31/12/2021, ,285531.04,6692367.359999999, diversi a diversi,,,,,
9.12.002,CONTRIBUTI IN CONTO ESERCIZIO ,31/12/2021,150,F-MOBILITY PARTNER , ,31/12/2021, ,303512.88,6388854.48, diversi a diversi,,,,,
9.12.002,CONTRIBUTI IN CONTO ESERCIZIO ,31/12/2021,150,P-MOBILITY PARTNER , ,31/12/2021, ,261053.28,6127801.199999999, diversi a diversi,,,,,
9.12.002,CONTRIBUTI IN CONTO ESERCIZIO ,31/12/2021,150,NEON , ,31/12/2021, ,1510.59,6126290.609999999,516001 RISCONTI PASSIVI,,,,,
9.12.002,CONTRIBUTI IN CONTO ESERCIZIO ,31/12/2021,160,E-BREWERY , ,31/12/2021, ,-11999.62,6138290.23, diversi a diversi,,,,,
9.12.002,CONTRIBUTI IN CONTO ESERCIZIO ,31/12/2021,160,E-DEDIGN , ,31/12/2021, ,-6158.98,6144449.21, diversi a diversi,,,,,
9.12.002,CONTRIBUTI IN CONTO ESERCIZIO ,31/12/2021,160,INNOVARE , ,31/12/2021, ,-79326.13,6223775.34, diversi a diversi,,,,,
9.12.002,CONTRIBUTI IN CONTO ESERCIZIO ,31/12/2021,160,CNOS-PERSONALE , ,31/12/2021, ,-52845.88,6276621.22, diversi a diversi,,,,,
9.12.002,CONTRIBUTI IN CONTO ESERCIZIO ,31/12/2021,150,CNOS , ,31/12/2021, ,4312944.0,1963677.22, diversi a diversi,,,,,
9.12.002,CONTRIBUTI IN CONTO ESERCIZIO ,31/12/2021,150,MARINE HAZARD , ,31/12/2021, ,41155.67,1922521.55, diversi a diversi,,,,,
9.12.002,CONTRIBUTI IN CONTO ESERCIZIO ,31/12/2021,150,7 SHIELD , ,31/12/2021, ,94813.68,1827707.87, diversi a diversi,,,,,
9.12.002,CONTRIBUTI IN CONTO ESERCIZIO ,31/12/2021,150,H2020 INCISIVE , ,31/12/2021, ,162520.83,1665187.04, diversi a diversi,,,,,
9.12.002,CONTRIBUTI IN CONTO ESERCIZIO ,31/12/2021,150,C-MOBILITY , ,31/12/2021, ,4443.16,1660743.88, diversi a diversi,,,,,
9.12.002,CONTRIBUTI IN CONTO ESERCIZIO ,31/12/2021,150,F-MOBILITY , ,31/12/2021, ,29866.3,1630877.58, diversi a diversi,,,,,
9.12.002,CONTRIBUTI IN CONTO ESERCIZIO ,31/12/2021,150,P-MOBILITY , ,31/12/2021, ,3976.9,1626900.68, diversi a diversi,,,,,
9.12.003,SOPRAVVENIENZE ATTIVE ,31/01/2021,1100,FATTURA DI ACQUISTO,37469,30/12/2020,2,-95.57,95.57,"PCSPEC PC Specialist Ltd,",,,,,
9.12.003,SOPRAVVENIENZE ATTIVE ,30/04/2021,1110,ACQUISTO IVA N/DETR,FPR8/21,22/04/2021,125,-958.14,1053.71,ICTSUD CENTRO DI COMPETEN,,,,,
9.12.003,SOPRAVVENIENZE ATTIVE ,31/08/2021,160,GIROCONTO ACCONTI D, ,31/08/2021, ,-2342.0,3395.71, diversi a diversi,,,,,
9.12.006,INSUSSISTENZE DEL PASSIVO ,02/01/2021,160,ADDEGUAMENTO , ,02/01/2021, ,-9657.04,9657.04,216003 ERARIO C/IVA,,,,,
9.12.006,INSUSSISTENZE DEL PASSIVO ,02/01/2021,160,INSUSSISTENZA , ,02/01/2021, ,-8468.34,18125.38,506005 ALTRI ORGANISMI SO,,,,,
9.12.006,INSUSSISTENZE DEL PASSIVO ,31/08/2021,160,IMPOSTE IRAP 2020 D, ,31/08/2021, ,-443.66,18569.04,507014 ERARIO C/DEBITI X,,,,,
9.12.006,INSUSSISTENZE DEL PASSIVO ,31/12/2021,160,RIMOD.FIRE DEB/PART, ,31/12/2021, ,-314.37,18883.41, diversi a diversi,,,,,
9.12.006,INSUSSISTENZE DEL PASSIVO ,31/12/2021,160,RIMOD.NEON DEB/PART, ,31/12/2021, ,-7001.75,25885.16, diversi a diversi,,,,,
9.16.004,RICAVI DIVERSI ,30/08/2021,200,FATTURA DI VENDITA ,27/2021,30/08/2021,27,-301.15,301.15,ATHENA ATHENA S.R.L.,,,,,
9.16.004,RICAVI DIVERSI ,07/09/2021,200,FATTURA DI VENDITA ,30/2021,07/09/2021,30,-172.76,473.91,ATHENA ATHENA S.R.L.,,,,,
9.16.004,RICAVI DIVERSI ,23/11/2021,200,FATTURA DI VENDITA ,46/2021,23/11/2021,46,-165.56,639.47,ATHENA ATHENA S.R.L.,,,,,
9.16.004,RICAVI DIVERSI ,20/12/2021,200,FATTURA DI VENDITA ,51/2021,20/12/2021,51,-159.99,799.46,ATHENA ATHENA S.R.L.,,,,,
9.16.004,RICAVI DIVERSI ,22/12/2021,200,FATTURA DI VENDITA ,52/2021,22/12/2021,52,-120.74,920.2,ATHENA ATHENA S.R.L.,,,,,
9.16.005,CORRISP. C/PRESTAZIONI DI SERVIZIO ,24/02/2021,200,FATTURA DI VENDITA ,44317,24/02/2021,5,-2800.0,2800.0,ANSSTS ANSALDO STS SPA A,,,,,
9.16.005,CORRISP. C/PRESTAZIONI DI SERVIZIO ,22/03/2021,200,FATTURA DI VENDITA ,44348,22/03/2021,6,-5000.0,7800.0,VISHAY VISHAY SEMICONDUCT,,,,,
9.16.005,CORRISP. C/PRESTAZIONI DI SERVIZIO ,07/04/2021,200,FATTURA DI VENDITA ,44378,07/04/2021,7,-9000.0,16800.0,GEMELE G.E.M. Elettronica,,,,,
9.16.005,CORRISP. C/PRESTAZIONI DI SERVIZIO ,13/04/2021,200,FATTURA DI VENDITA ,44409,13/04/2021,8,-20000.0,36800.0,JABILC JABIL CIRCUIT ITAL,,,,,
9.16.005,CORRISP. C/PRESTAZIONI DI SERVIZIO ,28/04/2021,200,FATTURA DI VENDITA ,44440,28/04/2021,9,-7500.0,44300.0,ANSSTS ANSALDO STS SPA A,,,,,
9.16.005,CORRISP. C/PRESTAZIONI DI SERVIZIO ,30/04/2021,200,FATTURA DI VENDITA ,44470,30/04/2021,10,-24400.0,68700.0,ANSSTS ANSALDO STS SPA A,,,,,
9.16.005,CORRISP. C/PRESTAZIONI DI SERVIZIO ,12/05/2021,200,FATTURA DI VENDITA ,44501,12/05/2021,11,-57377.05,126077.05,METODA METODA S.P.A.,,,,,
9.16.005,CORRISP. C/PRESTAZIONI DI SERVIZIO ,26/05/2021,200,FATTURA DI VENDITA ,44531,26/05/2021,12,-4000.0,130077.05,AIPART Ai Parts Srl,,,,,
9.16.005,CORRISP. C/PRESTAZIONI DI SERVIZIO ,28/05/2021,200,FATTURA DI VENDITA ,13/2021,28/05/2021,13,-10000.0,140077.05,ANSSTS ANSALDO STS SPA A,,,,,
9.16.005,CORRISP. C/PRESTAZIONI DI SERVIZIO ,03/06/2021,200,FATTURA DI VENDITA ,14/2021,03/06/2021,14,-4000.0,144077.05,TEFIN TEFIN S.C.R.L.,,,,,
9.16.005,CORRISP. C/PRESTAZIONI DI SERVIZIO ,14/06/2021,200,FATTURA DI VENDITA ,15/2021,14/06/2021,15,-15000.0,159077.05,VISHAY VISHAY SEMICONDUCT,,,,,
9.16.005,CORRISP. C/PRESTAZIONI DI SERVIZIO ,22/06/2021,200,FATTURA DI VENDITA ,16,22/06/2021,16,-10000.0,169077.05,ABBPOW ABB POWER GRIDS SW,,,,,
9.16.005,CORRISP. C/PRESTAZIONI DI SERVIZIO ,05/07/2021,200,FATTURA DI VENDITA ,17/2021,05/07/2021,17,-37000.0,206077.05,TOPIN TOP-IN S.C.A.R.L.,,,,,
9.16.005,CORRISP. C/PRESTAZIONI DI SERVIZIO ,09/07/2021,1200,FATTURA DI VENDITA ,18,09/07/2021,18,10000.0,196077.05,ABBPOW ABB POWER GRIDS SW,,,,,
9.16.005,CORRISP. C/PRESTAZIONI DI SERVIZIO ,09/07/2021,200,FATTURA DI VENDITA ,19,09/07/2021,19,-5000.0,201077.05,ABBPOW ABB POWER GRIDS SW,,,,,
9.16.005,CORRISP. C/PRESTAZIONI DI SERVIZIO ,09/07/2021,200,FATTURA DI VENDITA ,20,09/07/2021,20,-5000.0,206077.05,ABBPOW ABB POWER GRIDS SW,,,,,
9.16.005,CORRISP. C/PRESTAZIONI DI SERVIZIO ,20/07/2021,200,FATTURA DI VENDITA ,21/2021,20/07/2021,21,-12500.0,218577.05,R4I R4I S.R.L.,,,,,
9.16.005,CORRISP. C/PRESTAZIONI DI SERVIZIO ,26/07/2021,200,FATTURA DI VENDITA ,22/2021,26/07/2021,22,-18000.0,236577.05,GEMELE G.E.M. Elettronica,,,,,
9.16.005,CORRISP. C/PRESTAZIONI DI SERVIZIO ,09/08/2021,200,FATTURA DI VENDITA ,24/2021,09/08/2021,24,-98131.15,334708.2,METODA METODA S.P.A.,,,,,
9.16.005,CORRISP. C/PRESTAZIONI DI SERVIZIO ,25/08/2021,1200,FATTURA DI VENDITA ,25,25/08/2021,25,5000.0,329708.2,ABBPOW ABB POWER GRIDS SW,,,,,
9.16.005,CORRISP. C/PRESTAZIONI DI SERVIZIO ,25/08/2021,200,FATTURA DI VENDITA ,26,25/08/2021,26,-5000.0,334708.2,HITABB HITACHI ABB POWER,,,,,
9.16.005,CORRISP. C/PRESTAZIONI DI SERVIZIO ,31/08/2021,1200,FATTURA DI VENDITA ,28,31/08/2021,28,5000.0,329708.2,ABBPOW ABB POWER GRIDS SW,,,,,
9.16.005,CORRISP. C/PRESTAZIONI DI SERVIZIO ,31/08/2021,200,FATTURA DI VENDITA ,29,31/08/2021,29,-5000.0,334708.2,HITABB HITACHI ABB POWER,,,,,
9.16.005,CORRISP. C/PRESTAZIONI DI SERVIZIO ,27/09/2021,200,FATTURA DI VENDITA ,32/2021,27/09/2021,32,-154000.0,488708.2,METODA METODA S.P.A.,,,,,
9.16.005,CORRISP. C/PRESTAZIONI DI SERVIZIO ,30/09/2021,200,FATTURA DI VENDITA ,33/2021,30/09/2021,33,-20000.0,508708.2,ANSSTS ANSALDO STS SPA A,,,,,
9.16.005,CORRISP. C/PRESTAZIONI DI SERVIZIO ,05/10/2021,200,FATTURA DI VENDITA ,34/2021,05/10/2021,34,-126000.0,634708.2,GESANS GESAN S.R.L.,,,,,
9.16.005,CORRISP. C/PRESTAZIONI DI SERVIZIO ,21/10/2021,200,FATTURA DI VENDITA ,36/2021,21/10/2021,36,-4000.0,638708.2,CONTR1 Contrader S.R.L.,,,,,
9.16.005,CORRISP. C/PRESTAZIONI DI SERVIZIO ,02/11/2021,200,FATTURA DI VENDITA ,37/2021,02/11/2021,37,-18000.0,656708.2,GEMELE G.E.M. Elettronica,,,,,
9.16.005,CORRISP. C/PRESTAZIONI DI SERVIZIO ,15/11/2021,200,FATTURA DI VENDITA ,38/2021,15/11/2021,38,-20000.0,676708.2,NGMEDS Ng Med S.R.L.,,,,,
9.16.005,CORRISP. C/PRESTAZIONI DI SERVIZIO ,15/11/2021,200,FATTURA DI VENDITA ,39/2021,15/11/2021,39,-13250.0,689958.2,ANSSTS ANSALDO STS SPA A,,,,,
9.16.005,CORRISP. C/PRESTAZIONI DI SERVIZIO ,16/11/2021,200,FATTURA DI VENDITA ,41/2021,16/11/2021,41,-28655.74,718613.94,AKSRL AK-12 SRL,,,,,
9.16.005,CORRISP. C/PRESTAZIONI DI SERVIZIO ,17/11/2021,200,FATTURA DI VENDITA ,42/2021,17/11/2021,42,-11344.26,729958.2,AKSRL AK-12 SRL,,,,,
9.16.005,CORRISP. C/PRESTAZIONI DI SERVIZIO ,18/11/2021,200,FATTURA DI VENDITA ,43/2021,18/11/2021,43,-8000.0,737958.2,MACROP Macropharm S.R.L.,,,,,
9.16.005,CORRISP. C/PRESTAZIONI DI SERVIZIO ,18/11/2021,200,FATTURA DI VENDITA ,44/2021,18/11/2021,44,-85000.0,822958.2,ATHENA ATHENA S.R.L.,,,,,
9.16.005,CORRISP. C/PRESTAZIONI DI SERVIZIO ,23/11/2021,200,FATTURA DI VENDITA ,45/2021,23/11/2021,45,-15000.0,837958.2,JABER JABER INNOVATION S,,,,,
9.16.005,CORRISP. C/PRESTAZIONI DI SERVIZIO ,24/11/2021,200,FATTURA DI VENDITA ,47/2021,24/11/2021,47,-15000.0,852958.2,VISHAY VISHAY SEMICONDUCT,,,,,
9.16.005,CORRISP. C/PRESTAZIONI DI SERVIZIO ,10/12/2021,200,FATTURA DI VENDITA ,48/2021,10/12/2021,48,-13610.66,866568.86,AZIEN3 AZIENDA SERVIZI IG,,,,,
9.16.005,CORRISP. C/PRESTAZIONI DI SERVIZIO ,10/12/2021,200,FATTURA DI VENDITA ,48/2021,10/12/2021,48,0.0,866568.86,AZIEN3 AZIENDA SERVIZI IG,,,,,
9.16.005,CORRISP. C/PRESTAZIONI DI SERVIZIO ,14/12/2021,1200,FATTURA DI VENDITA ,49/2021,14/12/2021,49,15000.0,851568.86,JABER JABER INNOVATION S,,,,,
9.16.005,CORRISP. C/PRESTAZIONI DI SERVIZIO ,14/12/2021,200,FATTURA DI VENDITA ,50/2021,14/12/2021,50,-15000.0,866568.86,JABER JABER INNOVATION S,,,,,
9.16.005,CORRISP. C/PRESTAZIONI DI SERVIZIO ,31/12/2021,150,ATHENA COMPET.2022 , ,31/12/2021, ,68000.0,798568.86,516001 RISCONTI PASSIVI,,,,,
